-arvoinen	-arvoinen
-ban	-ban
-ciäkká	-ceahkká
-gin	-gin
-gis	-gis
-go	-go
-gyettiđ	-guohttit
-gân	-gan
-gâs	-gas
-heivi	-heivi
-hân	-han
-kiärdásâš	-keardásaš
-kodde	-koddi
-kápuluh	-kápulut
-luággi	-loaggi
-lágán	-lágán
-mat	-mat
-piäiválâš	-peaiválaš
-piäivásâš	-peaivásaš
-poi	-poi
-ruottâ	-ruohtta
-râk	-rat
-sun	-sun
-tiepsi	-teaksi
-ttáá	-ttá
aa-a	á-a
aabis	ábis
aabiskirje	ábiskirji
aaibâs	áibas
aaigâ	áiga
aainâs	áinas
aainâs-uv	áinas-uv
aairâs	áiras
aajâ	ája
aalaaš	áláš
aalbâhvyesi	álbahvuosi
aaleeb	áleet
aalmugjeessân	álbmugjeessan
aalmugjeessânvuotâ	álbmugjeessanvuohta
aalmugškovlâ	álbmugškovla
aamnâs	ámnas
aanoost	ánost
aapiin	ápiin
aarrân	árran
aarâháldu	áraháldu
aassâmpäikki	ássampáihkki
aassâmsaje	ássamsaji
aassâmviäsu	ássamveasu
aassâđ	ássat
aasâ	ása
aavis	ávis
aavžâ	ávža
aaččân	áhččan
aaštâ	áita
abbâsiđ	abbasit
abstrakt	abstrakt
abstraktâ	abstrakta
acceem	ahcceen
acceeđ	ahcceet
acâgâstiđ	acagastit
acâkkistiđ	acagkistit
acâttiđ	acadtit
adai	adai
adaldâh	adaldat
adaluhčâđ	adalukčat
addalâš	addalaš
adde addâgâs	adde addagas
addiittijjee	addiihttijjei
addiittâllâđ	addiihttallat
addiđ	addit
addâgâs	addagas
adeliđ	adelit
adelâš	adelaš
adjektiiv	adjektiiv
adjektijvâ	adjektijva
aggâ	agga
agâstâllâđ	agastallat
ahevâššâđ	ahevaššat
ahheev	ahheev
ahheevvuotâ	ahheevvuohta
aibâšiđ	aibašit
aikkâ	aihkka
aimâkkâššâđ	aibmagkaššat
aimâsjieŋâ	aibmasjeaŋa
ain	ain
ain-uv	ain-uv
ainanneem-	ainadneem-
aittâlâstiđ	aihttalastit
aitârdiđ	aitardit
aitârdâs	aitardas
aiđumeennâm	aiđumeednan
aksel	aksel
alaniđ	alanit
alda	alda
aldaaš	aldáš
aldahyelkki	aldahuolki
aldaniđ	aldanit
aldaolmooš	aldaolbmoš
aldasáid	aldasáit
aldasâš	aldasaš
aldâgâs	aldagas
alemus	alemus
algaaš	algáš
alge	algi
algâ	alga
algâ-	alga-
algâttiđ	algadtit
algâttâs	algadtas
alkohollijgekevttee	alkohollijgekevttei
almaa	albmá
almai	albmai
almaš	albmaš
almenähki	albmenáhgi
almenäkki	albmenáhkki
almetuulâš	albmetulaš
almevierccâ	albmevearcca
almolâš	albmolaš
almos	albmos
almostuđ	albmostut
almâsiđ	albmasit
alnaad	alnát
alnaan	alnán
alne	alni
alnees	alnees
alo	alo
alodâh	alodat
alosâš	alosaš
ama	ama
amahmis	amahmis
amal	amal
ambulans	ambulans
amnâslâš	amnaslaš
amâhân	amahan
anadâttâđ	anadadtat
anestiđ	anestit
anettiđ	anehttit
anneeđ	adneet
anneeđ ävkkin	adneeđ ávkkin
ano	ano
anolâs	anolas
anolâš	anolaš
anopihtâseh	anopihtaset
ansun	ansun
apila	apila
apina	apina
apseđ	akset
arbiđ	arbit
argument	argument
arguđ	argut
argâpihtâseh	argabihtaset
arkkâdâh	arkadat
artikkâl	artihkkal
arvaa	arvá
arvađ	arvvat
arve-	arve-
arven	arvven
arvenallii	arvvenallii
arvesiiđâr	arvvesiiđar
arvetävgi	arvvetávgi
arveuáhti	arveoahti
arvešoŋŋâ	arvvešoŋŋa
arvâlistiđ	arvvalistit
arvâlus	arvvalus
arvâlâddâđ	arvvaladdat
arvâlâs	arvvalas
asalâš	asalaš
asettaa	asehttá
asettem	asehtten
asettuđ	asehttut
asfalt	asfalt
askadâllâđ	askadallat
askadâs	askadas
aske	aski
asker	asker
aso	aso
asodâh	asodat
asosâš	asosaš
assaa	assá
assaavuotâ	assávuohta
assistent	assistent
astel	astel
astkääri	astgári
asto	asto
astottesvuotâ	astohttesvuohta
astoäigi	astoáigi
asun	asun
asâttiđ	asadtit
asâttâs	asadtas
auto	auto
autokoori	autokori
avalâš	avalaš
avdo	avdo
avediđ	avedit
avra	avra
avâštâs	avaitas
avžuuttiđ	avžuhttit
avžuuttâs	avžuhttas
avžuđ	avžut
aččinj	ahččinj
aččinjkálgu	ahččinjkálgu
aččinjriččâ	ahččinjrihčča
aččinriččâ	ahččinrihčča
ađđiistâllâđ	ađđiistallat
ašt	ašt
aštâččiđ	aitahččit
bussi	bussi
caappâđ	cáhppat
cagge	caggi
cahâstiđ	cahastit
caimuđ	caibmut
caimâšuđ	caibmašut
canccoliđ	canccolit
canccođ	canccot
capâlistiđ	capalistit
casâstuh	casastut
cavgeliđ	cavgelit
cavâdiđ	cavadit
cavâstiđ	cavastit
cavâččiđ	cavahččit
ceehi	ceahi
ceehis	ceahis
ceevi	ceavi
ceggii	ceggii
ceggiistellee	ceggiistellei
ceggiistâllâđ	ceggiistallat
ceggiđ	ceggit
ceggâ	cegga
ceggâdiđ	ceggadit
ceggâniđ	cegganit
cegâttiđ	cegadtit
cekki	cehkki
cekkiđ	cehkkit
celkkiđ	celkit
celkkâliđ	celkalit
cerkki	cerki
cevziđ	cevzit
cibináš	cibináš
cicceeđ	cihcceet
cicceđ	cihccet
cicestiđ	cicestit
cicettiđ	cicehttit
cieggâđ	ceaggat
ciegâdiđ	ceagadit
ciegâstiđ	ceagastit
ciegâstâllâđ	ceagastallat
ciellâđ	ceallat
cielâttiđ	cealadtit
cieppâđ	ceahppat
ciirgâs	ciirgas
cilijdiđ	cilijdit
cilkkem	cilken
cilkkeđ	cilket
cimccâh	cimccat
cimostiđ	cimostit
cirgeđ	cirget
cirgádiđ	cirgádit
cirgálâh	cirgálat
cirgáđ	cirgát
cirhádiđ	cirhádit
cirkkeđ	cirket
ciskâđ	ciskat
civhádiđ	civhádit
civkkeđ	civkket
ciägguđ	ceaggut
ciägu-	ceagu-
ciägus	ceagus
ciähháđ	ceahhát
ciäkkuđ	ceahkkut
ciälhus	cealhus
ciälkkámuš	cealkámuš
ciälus	cealus
ciärkkádiđ	cearkádit
ciävvuliđ	ceavvulit
ciävvuđ	ceavvut
ciävzámâš	ceavzámaš
ciŋkkeđ	ciŋkket
ciŋkkáhâš	ciŋkkáhaš
coggâ-	cogga-
coggâđ	coggat
cogâsnjalmij	cogasnjalbmij
cohhuđ	cohhut
cokkiittiđ	cohkkiihttit
cokkiittâs	cohkkiihttas
cokkiđ	cohkkit
cokkâniđ	cohkkanit
colkkâliđ	colkalit
commâliđ	copmalit
coohhuđ	cohhut
cooijâđ	coijat
coommâđ	copmat
cooskâs	coskas
copciđ	copcit
cuggâđ	cuggat
cuikkádiđ	cuihkkádit
cuikkááttiđ	cuihkkáhttit
cuikkâliđ	cuihkkalit
cullâgyettiđ	cullaguohttit
cuobbuunjuolâ	cuobbunjuola
cuobbuunjuolâs	cuobbunjuolas
cuoigiđ	cuoigit
cuovhâs	cuovhas
cuovkkiittâllâđ	cuovkkiihttallat
cuovkkiđ	cuovkkit
cuovkkâniđ	cuovkkanit
cuozzâ	cuozza
curmáđ	curbmát
cuskâdiđ	cuskadit
cuvnuđ	cuvdnut
cuvnâđ	cuvdnat
cuáhi	coahi
cuáhudiđ	coahudit
cuáháduđ	coahádut
cuápcániđ	coapcánit
cuártti	coarti
cuávgááttiđ	coavgáhttit
cuávis	coavis
cuávkkuđ	coavkkut
cuáŋui	coaŋui
cuáŋuidittiđ	coaŋuidihttit
cuáŋuimáánu	coaŋuibmánu
cuáŋuliđ	coaŋulit
cyecci	cuohcci
cyezzi	cuozzi
cáhádiđ	cáhádit
cáhádâttâđ	cáhádadtat
cäimiđ	cáibmit
cäähiđ	cáhit
delta	delta
design	design
dokument	dokument
edirvâššâđ	edirvvaššat
eebir	eabir
eehi	eahi
eehid	eahit
eehiv	eahiv
eeijiđ	eaijit
eejiš	eajiš
eeleed	ealeet
eeleev	ealeev
eellim	eallin
eelliđ	eallit
eemeed	eameet
eenniš	eadniš
eennuš	eadnuš
eennâm	eadnan
eennâmluđ	eadnamlut
eennâmriddo	eadnamriddo
eennâmtuálu	eadnamdoalu
eennâmviljâlem	eadnamviljalen
eenâb	eanat
eenâbloho	eanabloho
eenâs	eanas
eestâ	easta
eeti	eati
eeči	eači
eeđâb	eađat
ehidij	ehidij
ehidist	ehidist
ehiduđ	ehidut
ehidâs-	ehidas-
ehidâsveigi	ehidasveigi
eidu	eidu
eimâskâs	eibmaskas
eivi	eivi
ejâččiđ	ejahččit
ekonomia	ekonomia
ekonomâlâš	ekonomalaš
elbâđ	elbat
ele	eli
elefant	elefant
elefantti	elefantti
elettiđ	elehttit
elettâttâđ	elehttadtat
elilâm	elilan
eljuttuđ	eljuhttut
ellee	ellei
elleekove	elleekovi
elleđ	ellet
elomáánu	elománu
elâliđ	elalit
elâččiđ	elahččit
emedâš	emedaš
enittiđ	enihttit
enni	edni
enniluđ	ednilut
ennilâš	ednilaš
ennustiđ	ednustit
ennuv	ednuv
ennâgâs	ednagas
enâbiššáá	enabiššá
enâdâh	enadat
enâmispuájui	enamispoajui
enâmistpuájui	enamistpoajui
ep	et
epideijee	epideijei
epidiđ	epidit
epioskolâš	epioskolaš
epitáválâš	epitáválaš
eppee	ehppei
eppeđ	ehppet
erduu	erdu
erduđ	erdut
erdâšuđ	erdašut
erehtuđ	erehtut
eres	eres
ereslágán	ereslágán
eresmuáđusâš	eresmoađusaš
ergi	ergi
ergijn	ergijn
erhittuđ	erhihttut
eromâš	eromaš
eromâšávt	eromašávt
ertpelsärgi	ertpelsárgi
ertpeltähti	ertpeltáhti
ervidiđ	ervvidit
esiväldi	esiváldi
esken	esken
eskenpalij	eskenpalij
essâ	essa
esteetlâš	esteetlaš
estiđ	estit
estuđ	estut
et	et
ete	eti
ettâ	ehtta
ettâđ	ehttat
evvisttem	evvistten
evvisttemesvuotâ	evvisttemesvuohta
ečiluđ	ečilut
ečirokke	ečirohkki
eđâbiššááš	eđabiššáš
eđâldâh	eđaldat
eštuu	eitu
faadâr	fádar
faainâhaajâ	fáinahája
faallâđ	fállat
faanin	fánin
faarpâl	fárpal
faaskâ	fáska
faddâ	fadda
faddârâš	faddaraš
fagge	faggi
faggođ	faggot
fakkist	fahkkist
fakkâ	fahkka
falskii	falskii
falskiđ	falskit
falâdeijee	faladeijei
falâldâh	falaldat
falâlistiđ	falalistit
falâliđ	falalit
falâluššâđ	falaluššat
fanttinâs	fanttinas
faskâttiđ	faskadtit
fastašiđ	fastašit
faste	fasti
fastâ	fasta
fastâomâdâh	fastaomadat
fattiittâttâđ	fahttiihttadtat
fattiđ	fahttit
fađostiđ	fađostit
fađđoođ	fađđot
faŋgâl	faŋgal
faškastâttâđ	faikastadtat
faškârâššâđ	faikaraššat
faškâstiđ	faikastit
faškâsâddâđ	faikasaddat
feerim	fearin
feeriđ	fearit
feiliđ	feilit
feilâ	feila
feilâstiđ	feilastit
ferttiđ	fertit
festivaal	festivál
ficcii	fihccii
fierttiđ	feartit
fiestâr	feastar
fievridiđ	feavridit
fiijnes	fiijnes
fijliđ	fijlit
fijnásávt	fijnásávt
filliittâttâđ	filliihttadtat
filliđ	fillit
filmâ	filbma
finniđ	fidnit
finnodâh	fidnodat
finnâšuđ	fidnašut
fiskiđ	fiskit
fiskodiđ	fiskodit
fiskáđ	fiskát
fiskâd	fiskat
fiärkkuđ	fearkut
fiärruđ	fearrut
fiärttu	feartu
fiärvá	fearvá
fiäránistiđ	fearánistit
fiäráán	fearán
fiävrásiđ	feavrásit
fiškáđ	fiikát
foostâg	fostat
forgâ	forga
formaallâš	forbmállaš
fyysilâš	fyysilaš
fámuttim	fámuhttin
fárudiđ	fárudit
fárulâš	fárulaš
fáámu	fámu
fááru	fáru
fáárun	fárun
fáárust	fárust
fáškuđ	fáikut
fáškáástâllâđ	fáikástallat
fáškáđ	fáikát
fäggi	fággi
fäggidiđ	fággidit
fälskittem	fálskihtten
fäškittiđ	fáikihttit
graafisâš	gráfisaš
graafâlâš	gráfalaš
haablâs	háblas
haahâđ	háhat
haajâ	hája
haalu	hálu
haamit	hámit
haandâl	hándal
haavdâr	hávdar
haavvâr	hávvar
hablii	hablii
hablâ-	habla-
hablâmuotâ	hablamuota
hacciđ	hahccit
hacâgiđ	hacagit
hacâttiđ	hacadtit
hadde	haddi
haijii	haijii
haijiđ	haijit
haikkâ	haihkka
hajijdiđ	hajijdit
haldiđ	haldit
haldâttâh	haldadtat
haldâttâs	haldadtas
haldâšiđ	haldašit
halijdiđ	halijdit
halkkâliđ	halkalit
halla	halla
hallittâs	hallihttas
hallâ	halla
halssiđ	halssit
hammiittâs	hapmiihttas
hammim	hapmin
hammin	hapmin
hamâstiđ	hamastit
handuk	handuk
hapattiđ	hapahttit
happiittiđ	hahppiihttit
harduđ	hardut
hardâččiđ	hardahččit
harijdiđ	harijdit
harijdâttiđ	harijdadtit
harppi	harpi
harriđ	harrit
harrâgoađistiđ	harragoađistit
harttađ	hartat
harâgiđ	haragit
hastâččiđ	hastahččit
hastâččâttâđ	hastahččadtat
haterâššâđ	hateraššat
hattiđ	hahttit
hattâ	hahtta
havdârdiđ	havdardit
havlâ	havla
havrijdiđ	havrijdit
havrâ-	havra-
havrâgiđ	havragit
havviđ	havvit
havvâšuttiđ	havvašuhttit
haŋgâ	haŋga
haŋkettiđ	haŋkehttit
haŋkkiđ	haŋkkit
haškâ	haika
haškâniđ	haikanit
heeilâ	heaila
heeilâr	heailar
heeitug	heaitut
heeppâd	heahppat
heeppâdlâš	heahppadlaš
heeppâdvuotâ	heahppadvuohta
heeviittiđ	heaviihttit
heevim	heavin
heeviđ	heavit
heevvâl	heavval
heeđâlm	heađaln
hei	hei
heiviittâllâđ	heiviihttallat
heiviittâs	heiviihttas
heiviđ	heivit
hejâpaarâ	hejabára
helduv-	helduv-
helduvah	helduvat
hellá	hellá
hellâ	hella
helmi	helbmi
helmimáánu	helbmimánu
helvit	helvit
hemâdid	hemadit
hemâdâs	hemadas
hepânâš!	hepanaš!
hepânâššâđ	hepanaššat
hersku	hersku
herttâ	herta
herttâčalme	hertačalbmi
herviđ	hervvit
hervâ	herva
hervâttiđ	hervvadtit
hervâttâs	hervvadtas
het-het	het-het
hettiđ	hehttit
hettâšuđ	hehttašut
hevvâlistiđ	hevvalistit
hevvâlttâs	hevvaltas
heŋgiđ	heŋgit
heŋgâsist	heŋgasist
heŋgâsiđ	heŋgasit
heŋgâstiđ	heŋgastit
heŋgâsân	heŋgasan
heŋgâvieltti	heŋgavealti
hicciđ	hihccit
hiettâđ	heahttat
hietâlistiđ	heatalistit
hiivsig	hiivsit
hilgottâttâđ	hilgohttadtat
hilgođ	hilgot
hillo	hillo
hiloi	hiloi
hilppániđ	hilpánit
hilttiđ	hiltit
hilui hálui	hilui hálui
hinná	hidná
hippâđ	hihppat
hirmos	hirbmos
hirmâd	hirbmat
hirmâdsâš	hirbmadsaš
hirmâdávt	hirbmadávt
historjá	historjá
hitodiđ	hitodit
hitruu	hitru
hittoođ	hihttot
hittáht	hihttáht
hitásávt	hitásávt
hivgâniđ	hivganit
hivviittiđ	hivviihttit
hivvâdâh	hivvadat
hiäibum	heaibon
hiäibustiđ	heaibustit
hiäibuttiđ	heaibuhttit
hiäibuđ	heaibut
hiäiloo	heailo
hiäilár	heailár
hiäimu	heaibmu
hiäimulâš	heaibmulaš
hiäimustiđ	heaibmustit
hiäimuš	heaibmuš
hiäivulâš	heaivulaš
hiäju	heaju
hiäjuluđ	heajulut
hiäjuniđ	heajunit
hiäjusmiđ	heajusmit
hiälppu	healpu
hiälssuđ	healssut
hiämáskiđ	heamáskit
hiäpášiđ	heapášit
hiäpášâtah	heapášadat
hiäpášâttâđ	heapášadtat
hiärkku	hearku
hiärruđ	hearrut
hiärrávuotâ	hearrávuohta
hiärsku	hearsku
hiärváá	hearvá
hiätu	heatu
hiävlá	heavlá
hiävláđ	heavlát
hiäđulâš	heađulaš
hiäđuttiđ	heađuhttit
hiäŋguđ	heaŋgut
hiäŋgáámettum	heaŋgámehtton
hiäŋgáđ	heaŋgát
hiđes	hiđes
hiđásmiđ	hiđásmit
hoidájeijee	hoidájeijei
hoittájeijee	hoihttájeijei
hoittáđ	hoihttát
hokâttâllâđ	hokadtallat
hommáđ	hopmát
hoohâđ	hohat
hoppuu	hohppu
hormendar	horbmendar
hormiš	horbmiš
hos	hos
hovdâ	hovda
hovkkâniđ	hovkkanit
huhkádiđ	huhgádit
huhtimáánu	huhtimánu
huidođ	huidot
huihádiđ	huihádit
huikkeđ	huihkket
huiláđ	huilát
huksiittâs	huksiihttas
huksiđ	huksit
hulijdiđ	hulijdit
hullân	hullan
huollii	huollii
huolâ	huola
huolâlâš	huolalaš
huolâtteijee	huoladteijei
huolâttiđ	huoladtit
huolâttâs	huoladtas
hure	huri
hurediđ	huredit
hurgettiđ	hurgehttit
hurgeđ	hurget
hurgottiđ	hurgohttit
hurgáttâllâđ	hurgáhttallat
hurgâliđ	hurgalit
hurijdiđ	hurijdit
hurráá	hurrá
hurtodiđ	hurtodit
hurttođ	hurtot
hurttáá	hurtá
hurtádiđ	hurtádit
hurváá	hurvá
huráidittiđ	huráidihttit
huttoođ	huhttot
huttáđ	huhttát
hutâgiđ	hutagit
hutârdiđ	hutardit
huuihâs	huihas
huummân	hupman
huunnjâđ	hunnjat
huvreluttiđ	huvreluhttit
huvreluđ	huvrelut
huvvá	huvvá
huáikkuđ	hoaihkkut
huálššáá	hoalššá
huámášittiđ	hoamášihttit
huámášiđ	hoamášit
huánnuđ	hoadnut
huánášiđ	hoanášit
huáppu	hoahppu
huáppulittiđ	hoahppulihttit
huáppust	hoahppust
huáputtiđ	hoapuhttit
huárástiđ	hoarástit
huátistiđ	hoatistit
huáttáđ	hoahttát
huávri	hoavri
huávristiđ	hoavristit
huávráskiđ	hoavráskit
huškoliđ	huikolit
huškottiđ	huikohttit
huškottâttâđ	huikohttadtat
huškođ	huikot
hušottiđ	hušohttit
huššâ	hušša
huššâlittiđ	huššalihttit
huššâliđ	huššalit
hyelkki	huolki
hyeneeht	huoneeht
hyenesuáinulâš	huonesoainulaš
hyeni	huoni
hyysig	hyysit
háccud	háhccut
háccuđ	háhccut
háccá	háhccá
háccá väzziđ	háhccá vázzit
háccáht	háhccáht
háccáđ	háhccát
háisuđ	háisut
háittu	háihttu
hálbášiđ	hálbášit
háldáttâs	háldáhttas
hálgu	hálgu
hállá	hállá
hálvát	hálvát
hámbuđ	hámbut
hámmáđ	hápmát
hámáiduđ	hámáidut
hámálâš	hámálaš
hámárdâllâđ	hámárdallat
hánášiđ	hánášit
háputtâllâđ	hápuhttallat
hárjuttiđ	hárjuhttit
hárjuttâllâm	hárjuhttallan
hárjuttâs	hárjuhttas
hárjá	hárjá
hárjánem	hárjánen
hárjániđ	hárjánit
hárruđ	hárrut
hárráht	hárráht
hárráđ	hárrát
hárvuđ	hárvvut
hárččuliđ	hárččulit
hárččulâhčâđ	hárččulakčat
hárččuđ	hárččut
hástu	hástu
hástuttiđ	hástuhttit
hástálâs	hástálas
hávdádiđ	hávdádit
hávdádâllâđ	hávdádallat
hávkkuđ	hávkkut
hávskuttâllâđ	hávskuhttallat
háváduttiđ	háváduhttit
háánnuđ	hádnut
háárán	hárán
háárááv	háráv
háástus	hástus
häittidiđ	háihttidit
hälbi	hálbi
hälbidiđ	hálbidit
hälhistittiđ	hálhistihttit
hälhistiđ	hálhistit
hältti	hálti
häppil	háhppil
häppilávt	háhppilávt
härdiđ	hárdit
härji	hárji
härjittiđ	hárjihttit
härvi	hárvi
härvidiđ	hárvvidit
häskidiđ	háskidit
hästiđ	hástit
hävdidiđ	hávdidit
hävdiduđ	hávdidut
hävdieennâm	hávdeaednan
hävidiđ	hávidit
hävski	hávski
hävvi	hávvi
häämi	hámi
häänis	hánis
häärvis	hárvvis
häävi	hávi
iberdettee	iberdehttei
iberdiđ	iberdit
ibárdâs	ibárdas
idde	iddi
idea	idea
idâluátu	idaloatu
ihe	ihi
ihepaje	ihepaji
ihepeeli	ihepeeli
ihepuddâ	ihepudda
iho	iho
ihteđ	ihtet
ihásávt	ihásávt
iidâ	iida
iimiš	iibmiš
iirgiš	iirgiš
iirâs	iiras
iiđeed	iiđeet
iiđeedpaje	iiđeedpaji
iiđeedpittá	iiđeedpihttá
iiŋâs	iiŋas
iiŋŋân	iiŋŋan
iiŋŋâđ	iiŋŋat
ij	ij
ijjâ	ijja
ijjâdiđ	ijjadit
ijjâsiđ	ijjasit
ijâstâllâđ	ijastallat
ikkân	ihkkan
ilbâd	ilbat
ilbâdâššâđ	ilbadaššat
ilgâd	ilgat
illá	illá
illávaijeeđ	illávaijeet
illávaje	illávaji
illâ	illa
illâluđ	illalut
ilos	ilos
iloskiđ	iloskit
ilosmittiđ	ilosmihttit
ilosmiđ	ilosmit
ilostuđ	ilostut
ilottiđ	ilohttit
ime	imi
immeev	ipmeev
imâšlâš	imašlaš
imâštâllâđ	imaitallat
individuaallâš	individuállaš
innig	idnit
innoođ	idnot
instituutio	institutio
investeerim	investeerin
investistim	investistin
iptos	iktos
irdelum	irdelon
irdeluđ	irdelut
irduđ	irdut
irdâluđ	irdalut
irge	irgi
irodiđ	irodit
irroođ	irrot
irrát	irrát
irâsmiđ	irasmit
irâsmuđ	irasmut
irâstâllâđ	irastallat
irâttiđ	iradtit
irâttâs	iradtas
iskos	iskos
iskâdiđ	iskadit
iskâstiđ	iskastit
iskâđ	iskat
it	it
italia-	italia-
italialaš	italialaš
itelistiđ	itelistit
iteliđ	itelit
itoi	itoi
itteeđ	ihtteet
itten	ihtten
ittum	ihtton
ittuđ	ihttut
ittáš	ihttáš
itám	itán
ivne	ivdni
ivnettuđ	ivdnehttut
ivniđ	ivdnit
ivnáiduđ	ivdnáidut
iä	ea
iäddudiđ	eaddudit
iädduđ	eaddut
iädudiđ	eadudit
iäigád	eaigát
iäljuttiđ	ealjuhttit
iäljár	ealjár
iällááttiđ	ealláhttit
iäluttem	ealuhtten
iälámâš	ealámaš
iäláskiđ	ealáskit
iäláttâh	ealáhttat
iäláttâs	ealáhttas
iälšu	ealšu
iän	ean
iännálâš	eadnálaš
iänui	eanui
iänáduttiđ	eanáduhttit
iänádâh	eanádat
iänáá	eaná
iänááš	eanáš
iänáážin	eanážin
iänášiđ	eanášit
iäpádâllâđ	eapádallat
iäpárâš	eapáraš
iärdudiđ	eardudit
iärgáduđ	eargádut
iärgádâh	eargádat
iärgáá	eargá
iäru	earu
iäruttiđ	earuhttit
iärániđ	earánit
iäránâššee	earánaššei
iäráán	earán
iässá	eassá
iätkáliđ	eatgálit
iätáduddâđ	eatáduddat
iätáduttiđ	eatáduhttit
iätásâš	eatásaš
iävtuttiđ	eavtuhttit
iävtuttâs	eavtuhttas
iävtutátulâš	eavtutátulaš
iävá	eavá
iäđus	eađus
iđedist	iđedist
iđedân	iđedan
iđedâs	iđedas
iđedâsmäälis	iđedasmális
iđedâspurrâmuš	iđedaspurramuš
iđeškyettiđ	iđeikuohttit
iŋádâh	iŋádat
iše	iši
išedeijee	išedeijei
išedistiđ	išedistit
išediđ	išedit
išepargee	išepargei
išesuándi	išesoandi
išteorroođ	iiteorrot
ištâdiđ	iitadit
ištâliđ	iitalit
ištâđ	iitat
išálâš	išálaš
iššeed	iššeet
iššáá	iššá
jaagiđ	jágit
jaamiš	jámiš
jaammuš	jápmuš
jaammâđ	jápmat
jaamâs	jámas
jaannâđ	jádnat
jalahistiđ	jalahistit
jalahâs	jalahas
jalhettiđ	jalhehttit
jalkkaattiđ	jalkáhttit
jalkkađ	jalkat
jalkkeđ	jalket
jallođ	jallot
jalŋes	jalŋes
jamâ	jama
jamâdiđ	jamadit
jarroođ	jarrot
javgâliđ	javgalit
jaŋgađ	jaŋgat
jeehiđ	jeahit
jeessân	jeassan
jeevil	jeavil
jeggi	jeggi
jeggiluátku	jeggiloatgu
jeggioppuu	jeggiohppu
jergâ	jerga
jesmi	jesmi
jeđe	jeđi
jieggâ	jeagga
jiegâlâš	jeagalaš
jieh	jeat
jieh-uv hepânâš!	jeah-uv hepanaš!
jiehiđ	jeahit
jieht	jeaht
jiehtinâš	jeahtinaš
jieijâs	jeaijas
jiellâh	jeallat
jielâ	jeala
jiem	jean
jienâ	jeana
jienâdiđ	jeanadit
jienâttemesvuotâ	jeanadtemesvuohta
jienâttuđ	jeanadtut
jierestuđ	jearestut
jiermi	jearbmi
jiesâ-	jeasa-
jiesâmielkki	jeasamealki
jiesâs	jeasas
jievjâ	jeavja
jievjâoppuu	jeavjaohppu
jievjâs	jeavjas
jievžâdiđ	jeavžadit
jiečânis	jeačanis
jiečânâs	jeačanas
jieččâd	jeahččat
jieččân	jeahččan
jieŋâ	jeaŋa
jieŋâ-	jeaŋa-
jieŋâkoolmâs	jeaŋagolbmas
jieŋâkuáldee	jeaŋagoaldei
jieŋâlmittiđ	jeaŋalbmihttit
jieŋâlâs	jeaŋalas
jieŋâpäldee	jeaŋabáldei
jieŋŋâl	jeaŋŋal
jieš	jeaš
jiešalnees	jeašalnees
jiešiäluid	jeašealuit
jieškii-uv	jeaikii-uv
jieškote-uv	jeaikote-uv
jieškotteev	jeaikohtteev
jiešmeidlist	jeašmeidlist
jiešmerideijee	jeašmerideijei
jiešpiäiválâš	jeašpeaiválaš
jiešráđálâš	jeašráđálaš
jiešvuotâ	jeašvuohta
jite	jiti
jive	jivi
jiäggáš	jeaggáš
jiägástuh	jeagástut
jiäháttâllâđ	jeaháhttallat
jiänádiđ	jeanádit
jiänáttâllâđ	jeanáhttallat
jiärmálâš	jearbmálaš
jiärmáá	jearbmá
jiärnâm	jearnan
jiäráskittee	jearáskihttei
jiärástum	jearáston
jiärástuđ	jearástut
jiäŋudiđ	jeaŋudit
jo	jo
jodottiđ	jodohttit
jogâldiđ	jogaldit
johân	johan
jolgâd	jolgat
jollâ	jolla
jollâvuotâ	jollavuohta
jolâstuđ	jolastut
jolâšiđ	jolašit
joo	jo
joo-o	jo-o
joommân	jopman
joreštiđ	joreitit
jorgettiđ	jorgehttit
jorgosiđ	jorgosit
jorgođ	jorgot
jormo	jorbmo
jorree	jorrei
jorreečuoldâ	jorreečuolda
joráduh	jorádut
jorádâs	jorádas
joráldâs	joráldas
jorŋii	jorŋii
jos	jos
josijdiđ	josijdit
josijduđ	josijdut
joskisluándusâš	joskisloandusaš
joskâ	joska
joskâd	joskat
joskâđ	joskat
jotelávt	jotelávt
jotkuđ	jotgut
jotkâ	jotga
jotkâškovliittâs	jotgaikovliihttas
jotkâškovlim	jotgaikovlin
joto	joto
jotteel	johtteel
jotteem	johtteen
jotteemčalme	johtteemčalbmi
jotteečalme	johtteečalbmi
jotteeđ	johtteet
jottáđ	johttát
jovgâttoh	jovgadtot
jođetteijee	jođehtteijei
jođettiđ	jođehttit
jođádâh	jođádat
joŋgâliđ	joŋgalit
juggáá	juggá
juhhee	juhhei
juhkeđ	juhget
juhle	juhli
juhlođ	juhlot
juhottiđ	juhohttit
juhâmuš	juhamuš
juhâmâš	juhamaš
juhâtermi	juhaderbmi
jukso	jukso
julediđ	juledit
julgâlâš	julgalaš
julkkeđ	julket
julle	julli
julme	julbmi
juláluđ	julálut
julâluđ	julalut
jumijdiđ	jumijdit
jumppa	jumppa
juna	juna
juná	juná
juohhuđ	juohhut
juohuđ	juohut
juoigâ	juoiga
juoigâstiđ	juoigastit
juoigâđ	juoigat
juollâd	juollat
juormiđ	juorbmit
juovdâdiđ	juovdadit
juovdâđ	juovdat
juovlah	juovlat
juovlâ-	juovla-
juovlâlähji	juovlaláhji
juovlâskeŋkkâ	juovlaskeŋkka
juovlâáptu	juovlaáktu
juovvân	juovvan
juovâdiđ	juovadit
juovâččem	juovahččen
juovâččiđ	juovahččit
juoŋâdiđ	juoŋadit
juoŋâstiđ	juoŋastit
jurbâd	jurbat
jurbâsmiđ	jurbasmit
jurbâsyeini	jurbasuoini
jurdeliđ	jurdelit
jurdeđ	jurdet
jurdijdiđ	jurdijdit
jurdâččiđ	jurdahččit
jurgâliđ	jurgalit
jurgâlâttâđ	jurgaladtat
jurmâliđ	jurbmalit
jurmâstiđ	jurbmastit
jurrâmâš	jurramaš
jursseđ	jursset
jurâdiđ	juradit
jussiđ	jussit
justuđ	justut
juttuđ	juhttut
jutâliđ	jutalit
juucâ	juca
juudalâš	judalaš
juuhâ	juha
juuhâđ	juhat
juullân	jullan
juullâđ	jullat
juulâ	jula
juulâs	julas
juummân	jupman
juumâ	juma
juurbâs	jurbas
juurdâ	jurda
juurdâpuáđus	jurdaboađus
juurrân	jurran
juurrâđ	jurrat
juurâ	jura
juuvdálâš	juvdálaš
juvâtteijee	juvadteijei
juvâttiđ	juvadtit
juáhhást	joahhást
juáhu	joahu
juáhuđ	joahut
juáháš	joaháš
juáigus	joaigus
juálgálâš	joalgálaš
juálgán	joalgán
juálgáá	joalgá
juálooh	joalot
juárbudekes	joarbudekes
juárbudeves	joarbudeves
juárbuđ	joarbut
juármáá	joarbmá
juáráduh	joarádut
juárŋi	joarŋi
juátkiđ	joatgit
juávkku	joavkku
juávviđ	joavvit
juŋkká	juŋkká
juŋâttuđ	juŋadtut
juŋŋâ	juŋŋa
juškeđ	juiket
jyehi	juohi
jyehiliđ	juohilit
jyehim	juohin
jyehimuáđusâš	juohimoađusaš
jyehipiäiválâš	juohipeaiválaš
jyehipiäiváš	juohipeaiváš
jyehitovvááš	juohitovváš
jyehivuođâst	juohivuođast
jyehiđ	juohit
jyelediđ	juoledit
jyelgi	juolgi
jyelgikeeči	juolgikeeči
jyelgimuorâ	juolgimuora
jyelgipeeli	juolgipeeli
jyelgipelgi	juolgipelgi
jyelgipärni	juolgipárni
jyelgirâš	juolgiraš
jyelgisuormâ	juolgisuorbma
jyelgittem	juolgihtten
jyelgittuđ	juolgihttut
jyelgičuijooh	juolgičuijot
jyemeehpeeli	juomeehbeeli
jyemehâš	juomehaš
jyevdil	juovdil
jyevdilistiđ	juovdilistit
jyevdilâs	juovdilas
jyevdiv	juovdiv
jyevdivâššâđ	juovdivaššat
já	já
jáháttâllâđ	jáháhttallat
jáldu	jáldu
jámálgiđ	jámálgit
jámálgâddâđ	jámálgaddat
jándur	jándur
jávkuttâh	jávkuhttat
jávrádâh	jávrádat
jávuttem	jávuhtten
jávuttemesvuotâ	jávuhttemesvuohta
jávuttuttiđ	jávuhttuhttit
jávvu-	jávvu-
jáválduđ	jáváldut
jáá	já
jááldus	jáldus
jáámmám	jápmán
jáávuh	jávut
jähittiđ	jáhihttit
jämihánnáá	jámihádná
jämimettum	jámimehtton
jämittiđ	jámihttit
jämmee	jápmei
järdiđ	járdit
jävildiđ	jávildit
jävilduđ	jávildut
jäviljergâ	jáviljerga
jävkittiđ	jávkihttit
jäämmim	jápmin
jäämmimtavdâ	jápmimdavda
jäämmiđ	jápmit
jäävvil	jávvil
jäävvilluđ	jávvillut
jäävvilttuđ	jávviltut
kaaggâin	gággain
kaaljâ	gálja
kaamâ	gáma
kaasi	gási
kaastâ	gásta
kaattâđ	gáhttat
kaatâ	gáta
kaavhâd	gávhat
kaavâ	gáva
kacceđ	gahccet
kaggâ	gagga
kaggâsiđ	gaggasit
kaggâđ	gaggat
kagâttiđ	gagadtit
kahanuđ	gahanut
kahcii	gahcii
kahheeđ	gahheet
kahvel	gahvel
kaiccâ	gaihcca
kaiccâlääbis	gaihccalábis
kaidâđ	gaidat
kaimârig	gaibmarit
kaivađ	gaivat
kaivâstiđ	gaivastit
kaivâsâddâđ	gaivasaddat
kakkiđ	gahkkit
kakkârâs	gahkkaras
kal	gal
kalaallit nunaatlâš	galállit nunátlaš
kalanâm	galanan
kalanâttâđ	galanadtat
kale	gali
kale nuárvuinjuuneest-uv almai puátá	gale noarvuinjuneest-uv albmai poatá
kalehân	galehan
kales	gales
kalgodiđ	galgodit
kalgâđ	galgat
kalje	galji
kalkkâ	galka
kalmaattiđ	galbmáhttit
kalmadittiđ	galbmadihttit
kalmadâh	galbmadat
kalmattâh	galbmahttat
kalmettiđ	galbmehttit
kalmeđ	galbmet
kalveđ suvle	galveđ suvli
kalvâđ	galvat
kalšâd	galšat
kammâgâš	gapmagaš
kamuvnjune	gamuvnjuni
kamuvčeppi	gamuvčehppi
kamâdâttâđ	gamadadtat
kamâspiddonjälmi	gamaspiddonjálbmi
kamâttiđ	gamadtit
kanava	ganava
kandâ	ganda
kannattiđ	gadnahttit
kannu	gadnu
kansaškovlâ	gansaikovla
kapitaal	gapitál
kappeer	gahppeer
kappeerkyeppir	gahppeerkuohppir
kappeerloccâ	gahppeerlohcca
kapteen	gakteen
kapšattiđ	gapšahttit
karbuđ	garbut
karbâđ	garbat
kardeđ	gardet
kardin	gardin
karodiđ	garodit
karodâs	garodas
karottâs	garohttas
karreeđ	garreet
karrii	garrii
karttâđ	gartat
karveđ	garvvet
kasašiđ	gasašit
kaskoo	gasko
kaso	gaso
kasodiđ	gasodit
kasodâh	gasodat
kasosâš	gasosaš
kassa	gassa
kasseet	gasseet
kassâ	gassa
kastik	gastik
kastâdiđ	gastadit
kastâdâttâđ	gastadadtat
kastâđ	gastat
kaulur	gaulur
kaverdiđ	gaverdit
kavkker	gavkker
kavkkâđ	gavkkat
kavnuđ	gavdnut
kavnâttâttâđ	gavdnadtadtat
kavnâđ	gavdnat
kavnâđâttâđ	gavdnađadtat
kavra	gavra
kavraa	gavrá
kavreluttiđ	gavreluhttit
kavreluđ	gavrelut
kavrođ	gavrot
kavŋiđ	gavŋit
kazerdiđ	gazerdit
kačâdiđ	gačadit
kačâttiđ	gačadtit
kaččâlittiđ	gahččalihttit
kaččâliđ	gahččalit
kaččâđ	gahččat
kađottâs	gađohttas
kađvâdâttâđ	gađvadadtat
kađvâđ	gađvat
kađâdâttâđ	gađadadtat
kađâstiđ	gađastit
kaŋgâ	gaŋga
kaškos	gaikos
kašmârdeijee	gašmardeijei
kašnestuđ	gašnestut
kašneđ	gašnet
keehâđ	geahat
keemmân	geapman
keerriv-	gearriv-
keerrâđ	gearrat
keesi	geasi
keesih	geasit
keessil	geassil
keessiđ	geassit
keevvâđ	geavvat
keevâtlâš	geavadlaš
keevâtlâšvuotâ	geavadlašvuohta
keeči	geači
keeđhičevđi	geađhičevđi
keežild	geažilt
kehâdiđ	gehadit
kehârâttâm	geharadtan
kejimield	gejimealt
kejâdiđ	gejadit
kejâstiđ	gejastit
kejâstâllâđ	gejastallat
keldâšum	geldašon
keldâšuđ	geldašut
kelijdiđ	gelijdit
kemijdiđ	gemijdit
kenigâsvuotâ	genigasvuohta
kenski	genski
kepidiđ	gepidit
kerdi	gerdi
kerimâs	gerimas
keriveh	gerivet
kerni	gerni
kerâttuh	geradtut
kesieennâm	geseaednan
kesihâš	gesihaš
kesijâššâđ	gesijaššat
kesikume	gesikumi
kesimánusâš	gesimánusaš
kesimáánu	gesimánu
kesipieggâ	gesipeagga
kesipieggâláá	gesipeaggalá
kesipiegâmuš	gesipeagamuš
kesiäigi	geseaigi
kessuđ	gessut
ketki	getgi
kevhi	gevhi
kevidâh	gevidat
kevli	gevli
kevlidiđ	gevlidit
kevličuárvi	gevličoarvi
kevttim	gevttin
kevttimist	gevttimist
kevttiđ	gevttit
kevttuđ	gevttut
kevâttâs	gevadtas
kevâttâttâđ	gevadtadtat
kezidiđ	gezidit
kezzi	gezzi
keččee	gehččei
keččin	gehččin
keččâlem	gehččalen
keččâlemdiet	gehččalemdeat
keččâlistiđ	gehččalistit
keččâliđ	gehččalit
keččâlâddâđ	gehččaladdat
keččâđ	gehččat
keđgi	geđgi
keš	geš
kicceeđ	gihcceet
kiddejuđ	giddejut
kiddiđ	giddit
kiddâ	gidda
kieddi	geaddi
kieddisyeini	geaddisuoini
kieggi	geaggi
kiehârâttâm	geaharadtan
kiejâ	geaja
kieldiđ	gealdit
kieldâ	gealda
kieldâgâs	gealdagas
kieldâstivrâ	gealdastivra
kielestiđ	gealestit
kiellâđ	geallat
kielâ	geala
kielâdiđ	gealadit
kielâttuđ	gealadtut
kielâuksâ	gealauksa
kielâuáivi	gealaoaivi
kielâviälgu	gealavealgu
kiemni	geamni
kiemârdiđ	geamardit
kiepâ	geapa
kierdâm	geardan
kierdâvâš	geardavaš
kierdâđ	geardat
kieres	geares
kiergâd	geargat
kiergâniđ	gearganit
kiergâttiđ	geargadtit
kieskâd	geaskat
kiessuđ	geassut
kiessâđ	geassat
kiesâččiđ	geasahččit
kietkâm	geatgan
kietkâmkuávi	geatgamgoavi
kietkâmläbži	geatgamlábži
kietkâmvuáđu	geatgamvoađu
kietkâmâš	geatgamaš
kietkâđ	geatgat
kietâ	geata
kietâdâllâđ	geatadallat
kietâpeeli	geatabeeli
kietâtyeji	geataduoji
kievhi	geavhi
kievhuđ	geavhut
kievhâttuđ	geavhadtut
kievjâ	geavja
kievrâ	geavra
kievđâ	geavđa
kievŋis	geavŋis
kieđâlohlááiđuh	geađalohláiđut
kieđâvuššâđ	geađavuššat
kieŋŋâl	geaŋŋal
kieškâ	geaika
kieškânjavkke	geaikanjavkki
kieškâskivŋe	geaikaskivŋi
kihestiđ	gihestit
kiheštiđ	giheitit
kihlođ	gihlot
kihluđ	gihlut
kihtuđ	gihtut
kihtâ	gihta
kihtâlâs	gihtalas
kii	gii
kii tiätá	gii teatá
kiiccâđ	giihccat
kiidâs	giidas
kiijlu	giijlu
kiijtos	giijtos
kiijvástuđ	giijvástut
kiilu	giilu
kiinii	giinii
kiirâs	giiras
kiisur	giisur
kiivšád	giivšát
kiivšán	giivšán
kiivšás	giivšás
kijtolâš	gijtolaš
kijttevâš	gijttevaš
kijtto	gijtto
kijváskiđ	gijváskit
kikkárittiđ	gihkkárihttit
kikkâniđ	gihkkanit
kikse	giksi
kilbo	gilbo
kildeđ	gildet
kildásmittiđ	gildásmihttit
killeel	gilleel
killájeijee	gillájeijei
killám	gillán
killáđ	gillát
kilomeetter	gilomeehtter
kilomeettersâš	gilomeehttersaš
kilupeeli	gilupeeli
kilášiđ	gilášit
kilšápolvâ	gilšápolva
kincceđ	ginccet
kinttâlvuojâ	ginttalvuoja
kipo	gipo
kippar	gihppar
kirdee	girdei
kirdeekutkâ	girdeekutga
kirdeliđ	girdelit
kirdemkieddi	girdemgeaddi
kirdemmaašin	girdepmášin
kirdemsajattâh	girdemsajahttat
kirdeđ	girdet
kirje	girji
kirječällee	girječállei
kirjálâš miärádâs	girjálaš mearádas
kirkes	girkes
kirkesvuotâ	girkesvuohta
kirkkoeennâm	girkoeednan
kirkkosijdâ	girkosijda
kirkkosundee	girkosundei
kirkkoveerdi	girkoveerdi
kirkveerdi	girkveerdi
kirnođ	girnot
kirrâsávt	girrasávt
kirâttiđ	giradtit
kiskeđ	gisket
kissá	gissá
kissákyeli	gissákuoli
kisto	gisto
kistâkkistiđ	gistagkistit
kisákiällu	gisákeallu
kittiđ	gihttit
kivkked	givkket
kivkker	givkker
kivkkáá	givkká
kivriđ	givrit
kivsediđ	givsedit
kizijdiđ	gizijdit
kiädduđ	geaddut
kiäddááttiđ	geaddáhttit
kiähnu	geahnu
kiäigusjuolgij	geaigusjuolgij
kiäinu	geainu
kiäjus	geajus
kiälbuttem	gealbuhtten
kiälbuttim	gealbuhttin
kiäldulâš	gealdulaš
kiäldálittiđ	gealdálihttit
kiälkká	gealká
kiällu	geallu
kiällupuásui	geallupoasui
kiällusyeini	geallusuoini
kiällár	geallár
kiällâr	geallar
kiälástâllâđ	gealástallat
kiämádâh	geamádat
kiämáidittiđ	geamáidihttit
kiännii	geadnii
kiäpu	geapu
kiäpásmittiđ	geapásmihttit
kiärdu	geardu
kiärduttiđ	gearduhttit
kiärdučalme	geardučalbmi
kiärdučuárvi	geardučoarvi
kiärduđ	geardut
kiärgus	geargus
kiärpáš	gearpáš
kiäst	geast
kiästen	geasten
kiästudiđ	geastudit
kiäsu	geasu
kiäsuttiđ	geasuhttit
kiäsádittiđ	geasádihttit
kiäsádâh	geasádat
kiäsáttâh	geasáhttat
kiävhášiđ	geavhášit
kiävrudiđ	geavrudit
kiävruđ	geavrut
kiävttu	geavttu
kiävtust	geavtust
kiävuliđ	geavulit
kiävulâs	geavulas
kiävvoo	geavvo
kiävvuđ	geavvut
kiävááš	geaváš
kiäzzuđ	geazzut
kiäzzániđ	geazzánit
kiäzášiđ	geazášit
kiäčán	geačán
kiäččá	geahččá
kiđâštiđ	giđaitit
kiđđâ	giđđa
kiđđâluđ	giđđalut
kiđđâláá	giđđalá
kiškodiđ	giikodit
kiškodâttâđ	giikodadtat
kiškođ	giikot
kiškuđ	giikut
kišto	giito
kištodiđ	giitodit
kištottâllâm	giitohttallan
kištottâllâđ	giitohttallat
ko	go
kobbâ	gobba
kobdodâh	gobdodat
kobdođ	gobdot
kobdádâs	gobdádas
kobdániđ	gobdánit
kobdášiđ	gobdášit
koblođ	goblot
kobđođ	gobđot
kocceem	gohcceen
kocceeđ	gohcceet
koccoođ	gohccot
koccááttiđ	gohccáhttit
koccáđ	gohccát
kodde	goddi
koddesäplig	goddesáplit
koddeđ	goddet
kodos	godos
koggoon	goggon
kogo	gogo
kohhuđ	gohhut
kohádiđ	gohádit
kohádâttâđ	gohádadtat
kohâstiđ	gohastit
koibâ	goiba
koibâkappeer	goibagahppeer
koijâdiđ	goijadit
koistâs	goistas
kojo	gojo
kojâttiđ	gojadtit
kokkiđ	gohkkit
kokkâ	gohkka
kokkâsiđ	gohkkasit
kokkâsâddâđ	gohkkasaddat
kolbâ	golba
koldeđ	goldet
koldâ	golda
kolgee	golgei
kolgodiđ	golgodit
kolgonjäbbi	golgonjábbi
kolgâmuš	golgamuš
kolgâvetteđ	golgavehttet
kolgâđ	golgat
kolkkiistiđ	golkiistit
kolkkiittuđ	golkiihttut
kolkkiđ	golkit
kollii	gollii
kolliistâllâđ	golliistallat
kolliđ	gollit
kolloođ	gollot
kolmum	golbmon
kolmuuttiđ	golbmuhttit
kolmuđ	golbmut
kolmâsvuotâ	golbmasvuohta
kolmâšiđ	golbmašit
kolmâštuđ	golbmaitut
kolo	golo
kolottiđ	golohttit
kolšâ	golša
komettiđ	gomehttit
komme	gopmi
komment	gopment
komponent	gomponent
komálâš	gomálaš
komániđ	gománit
konferens	gonferens
konnâ	godna
konsert	gonsert
konttur	gonttur
koodâs	godas
kooidâs	goidas
kooli	goli
koolmâ	golbma
koolmâs	golbmas
koommâr	gopmar
kooniš	goniš
koori	gori
koorood	gorot
koorrân	gorran
koorrâđ	gorrat
koorâin	gorain
koorânj	goranj
koorâs	goras
kooskâi	goskai
kooskâst	goskast
kooskâš	goskaš
koozâš	gozaš
koođijn	gođijn
kope	gopi
koppáristiđ	gohppáristit
koppâ	gohppa
koppâlakke	gohppalahkki
kopsettâttâđ	goksehttadtat
kopseđ	gokset
kopšâđ	gopšat
korccâ	gorcca
kordâđ	gordat
korgus	gorgus
korguu	gorgu
korgâd	gorgat
korkkâđ	gorkat
korottiđ	gorohttit
korppâsâddâđ	gorpasaddat
korristâllâđ	gorristallat
korriđ	gorrit
korrâ	gorra
korrâdiđ	gorradit
korrâdâššâđ	gorradaššat
korrâpieggâ	gorrabeagga
korrâsávt	gorrasávt
korsâ	gorsa
kortti	gorti
korttâ	gorta
korttâđ	gortat
korâdiđ	goradit
korâšiđ	gorašit
korŋiittâh	gorŋiihttat
koržáá	goržá
koskkuálsi	goskkoalsi
koskohoi	goskohoi
koskokko	goskohkko
koskâ	goska
koskâl	goskal
koskâlumos	goskalumos
koskâm	goskan
koskâmus	goskamus
koskâmustáá	goskamustá
koskân	goskan
koskâstiđ	goskastit
koskâstuvvâi	goskastuvvai
koskâttuvvâi	goskadtuvvai
koskâvuotâ	goskavuohta
koskâvuođâ	goskavuođa
koskâđ	goskat
kosostiđ	gosostit
kossuv	gossuv
kossuvvuotâ	gossuvvuohta
kossâčalme	gossačalbmi
kost	gost
kosten	gosten
kostnii	gostnii
kostâdiđ	gostadit
kostâđ	gostat
kosádiđ	gosádit
kote	goti
kotemuš	gotemuš
kotârittiđ	gotarihttit
kovediđ	govedit
koveráiđu	goveráiđu
kovjâ	govja
kovjâsukkâr	govjasuhkkar
kovli	govli
kovlottiđ	govlohttit
kovolduđ	govoldut
kovoldâh	govoldat
kovoldâs	govoldas
kovvoođ	govvot
kovvârisnjune	govvarisnjuni
kovádâh	govádat
kovâdâs	govadas
kovŋiđ	govŋit
kozzâ	gozza
kozzâmuári	gozzamoari
kozzâsäplig	gozzasáplit
kozzâđ	gozzat
kozzâš	gozzaš
kočodiđ	gočodit
kočâdiđ	gočadit
kočâttiđ	gočadtit
kočâttâh	gočadtat
koččom	gohččon
koččođ	gohččot
koččâđ	gohččat
kođe	gođi
kođos	gođos
kođđeeđ	gođđeet
koškee	goikei
koškeeh	goikeet
koškejuolgij	goikejuolgij
koškekuolbâ	goikekuolba
koškes	goikes
košknjuš	gošknjuš
koško	goiko
koškádittiđ	goikádihttit
koškáduh	goikádut
koškánjâš	goikánjaš
koškášiđ	goikášit
koškâdiđ	goikadit
koškâliđ	goikalit
koškâđ	goikat
kriittâlâš	griihttalaš
kubduv	gubduv
kublâkkâs	gublagkas
kuccoom	guhccon
kudduđ	guddut
kuddâliđ	guddalit
kufettâr	gufehttar
kuhe	guhi
kuhediđ	guhedit
kuhes	guhes
kuhesperjâdâh	guhesperjadat
kuhesvástuppeivi	guhesvástuhppeivi
kuhheeht	guhheeht
kuhháá	guhhá
kuhháásiähá	guhháseahá
kuhij	guhij
kuhmáđ	guhmát
kuho	guho
kuhádâs	guhádas
kuhástuđ	guhástut
kuhášiđ	guhášit
kuhâstiđ	guhastit
kuhâstâllâđ	guhastallat
kuhâštiđ	guhaitit
kuikettiđ	guikehttit
kuikkáđ	guihkkát
kuittiđ	guihttit
kuittáđ	guihttát
kuittâg	guihttat
kuiváđ	guivát
kuje	guji
kukke	guhkki
kukken	guhkken
kukkod	guhkkot
kukkodkulij	guhkkodkulij
kukkosâš	guhkkosaš
kukká	guhkká
kukkâđ	guhkkat
kukse	guksi
kuldâleijee	guldaleijei
kuldâlâddâđ	guldaladdat
kulen	gulen
kulgâđ	gulgat
kullee	gullei
kulluuhâš	gulluhaš
kulluuttiđ	gulluhttit
kulluđ	gullut
kulme	gulbmi
kulmii	gulbmii
kulmááin	gulbmáin
kulmâ	gulbma
kulnâđ	gulnat
kulostuđ	gulostut
kulottem	gulohtten
kulâttiđ	guladtit
kulŋâđ	gulŋat
kume	gumi
kumisteevvil	gumisteevvil
kumppi	gumppi
kumâttâs	gumadtas
kundá	gundá
kundáhaldâttâs	gundáhaldadtas
kunniđ	gudnit
kunnjo	gunnjo
kunnâ	gudna
kunnâluđ	gudnalut
kunâgâtâr	gunagadar
kuo	guo
kuoblâ	guobla
kuobžâ	guobža
kuobžâduh	guobžadut
kuobžâluási	guobžaloasi
kuobžâpelji	guobžabelji
kuobžâčevđi	guobžačevđi
kuocijdiđ	guocijdit
kuocâ	guoca
kuodduustuvvâš	guoddustuvvaš
kuodduustâh	guoddustat
kuodduš	guodduš
kuoddâliđ	guoddalit
kuohtii	guohtii
kuohtuuh	guohtut
kuohâstiđ	guohastit
kuohâđ	guohat
kuoimiš	guoibmiš
kuoirâs	guoiras
kuoirâđ	guoirat
kuoirâšiđ	guoirašit
kuojâ	guoja
kuokšâd	guokšat
kuolah	guolat
kuolgâ	guolga
kuolgâmiärkkuđ	guolgamearkut
kuommâm	guopman
kuomâdiđ	guomadit
kuonâs	guonas
kuoppâđ	guohppat
kuorbâđ	guorbat
kuoro	guoro
kuorriđ	guorrit
kuorrâđ	guorrat
kuorssâđ	guorssat
kuorsâttâh	guorsadtat
kuorâ	guora
kuoskâttiđ	guoskadtit
kuoskâđ	guoskat
kuossiđ	guossit
kuossâđ	guossat
kuostuđ	guostut
kuostâ	guosta
kuostâdiđ	guostadit
kuosâ	guosa
kuovgâd	guovgat
kuovlâliđ	guovlalit
kuovlâđ	guovlat
kuovskistiđ	guovskistit
kuovskâstiđ	guovskastit
kuovtiš	guovtiš
kuovzâđ	guovzat
kuovâdiđ	guovadit
kuovâmáánu	guovamánu
kuovâstiđ	guovastit
kuovđâ	guovđa
kuovđâš	guovđaš
kuođâlduđ	guođaldut
kuođâttiđ	guođadtit
kuođđuđ	guođđut
kuoŋŋuuttiđ	guoŋŋuhttit
kuoškâ	guoika
kuppá	guhppá
kupsuđ	guksut
kupsâđ	guksat
kupâlistiđ	gupalistit
kupâlâs	gupalas
kurdeđ	gurdet
kurgâliđ	gurgalit
kurgâlâs	gurgalas
kurgâlâsnummeer	gurgalasnupmeer
kurkku	gurku
kurkkâ	gurka
kurpostiđ	gurpostit
kurppe	gurpi
kurppođ	gurpot
kurppáđ	gurpát
kurráđ	gurrát
kussâ	gussa
kussâkälbi	gussagálbi
kustoo	gusto
kustâ	gusta
kusâttâh	gusadtat
kutkâ	gutga
kuttii	guhttii
kuttâ	guhtta
kuullâđ	gullat
kuulmâi-kuulmâi	gulbmai-kulbmai
kuulmâs	gulbmas
kuuloold	gulolt
kuumpinjuolâ	gumpinjuola
kuumpinjuolâs	gumpinjuolas
kuuppâđ	guhppat
kuus	gus
kuusnii	gusnii
kuussân	gussan
kuussâđ	gussat
kuuvl	guvl
kuuđhâš	guđhaš
kuuđâlm	guđaln
kuuđâs	guđas
kuvdâdiđ	guvdadit
kuvdâđ	guvdat
kuvlân	guvlan
kuvzâđ	guvzat
kuábbáš	goabbáš
kuábás	goabás
kuáddá	goaddá
kuáddámuš	goaddámuš
kuáddániđ	goaddánit
kuádui	goadui
kuádádâh	goadádat
kuáhi	goahi
kuáhin	goahin
kuáhtáđ	goahtát
kuáhčá	goakčá
kuáivis	goaivis
kuáivu	goaivu
kuáivunjune	goaivunjuni
kuáivuttâh	goaivuhttat
kuáivuđ	goaivut
kuákki	goahkki
kuákkáriđ	goahkkárit
kuákkáđ	goahkkát
kuál	goal
kuálkki	goalki
kuálkkiđ	goalkit
kuálkkáđ	goalkát
kuálláá	goallá
kuálppih	goalpit
kuálppihâš	goalpihaš
kuálsi	goalsi
kuálussääni	goalussáni
kuálustiđ	goalustit
kuálásteijee	goalásteijei
kuálástiđ	goalástit
kuálástus	goalástus
kuámmir	goapmir
kuápuliđ	goapulit
kuárdiđ	goardit
kuárgu	goargu
kuárgudiđ	goargudit
kuáridiđ	goaridit
kuárjidiđ	goarjidit
kuárruđ	goarrut
kuárttil	goartil
kuáruldâh	goaruldat
kuárus	goarus
kuárusmiđ	goarusmit
kuárváđ	goarvvát
kuárádâs	goarádas
kuárániđ	goaránit
kuárŋudiđ	goarŋudit
kuárŋuttiđ	goarŋuhttit
kuás	goas
kuásij	goasij
kuáski	goaski
kuáskiv	goaskiv
kuáskulâš	goaskulaš
kuásmuđ	goasmut
kuássin	goassin
kuásti-	goasti-
kuástinjaddeđ	goastinjaddet
kuástis	goastis
kuástusist	goastusist
kuástuđ	goastut
kuástáá	goastá
kuásán	goasán
kuásástâllâđ	goasástallat
kuáti	goati
kuátipelji	goatipelji
kuáttum	goahtton
kuáttumeennâm	goahttumeednan
kuáttun	goahttun
kuáttuđ	goahttut
kuáttá	goahttá
kuátu	goatu
kuávdoo	goavdo
kuávdášlâš	goavdášlaš
kuávi	goavi
kuávlu	goavlu
kuávlukielâ	goavlukeala
kuávttáá	goavttá
kuávttáákooskâl	goavttákoskal
kuávtáš	goavtáš
kuávváđ	goavvát
kuáđutteijee	goađuhtteijei
kuáđuttiđ	goađuhttit
kuáđuttâh	goađuhttat
kuáđástâllâđ	goađástallat
kuáŋkkáđ	goaŋkkát
kuččuđ	guhččut
kuđjiđ	guđjit
kuđjo	guđjo
kuš	guš
kuškiidâttâđ	guikiidadtat
kuškijdiđ	guikijdit
kuškiđ	guikit
kuškâdiämááš	guikadeamáš
kuškâdiđ	guikadit
kuškâdâttâđ	guikadadtat
kuškâđ	guikat
kušottiđ	gušohttit
kuššâliđ	guššalit
kužžii	gužžii
kvaliteet	gvaliteet
kyecistiđ	guocistit
kyeddee	guoddei
kyeddil	guoddil
kyeddiliđ	guoddilit
kyeddimčääci	guoddimčáci
kyeddiđ	guoddit
kyedittiđ	guodihttit
kyehti	guohti
kyehtin	guohtin
kyeimi	guoibmi
kyekki	guohkki
kyelettem	guolehtten
kyelettuđ	guolehttut
kyeli	guoli
kyelipivdee	guolipivdei
kyelišeigi	guolišeigi
kyeppi	guohppi
kyerdiđ	guordit
kyermi	guorbmi
kyermis	guorbmis
kyessi	guossi
kyessist	guossist
kyestiđ	guostit
kyevdil	guovdil
kyevti	guovti
kyevtikáávnán	guovtikávdnán
kyevtis	guovtis
kyevtpeln	guovtpeln
kyeđđiđ	guođđit
kyeškirčuáimâš	guoikirčoaibmaš
káccuđ	gáhccut
kácášiđ	gácášit
káhvástâllâmkooskâst	gáhvástallamgoskast
káhváttuđ	gáhváhttut
káigá	gáigá
káigáá	gáigá
káinulâš	gáinulaš
káisá	gáisá
káivudâttâđ	gáivudadtat
káivuđ	gáivut
káivádiđ	gáivádit
kákku	gáhkku
kákárâttâđ	gákáradtat
kálgu	gálgu
kálgániđ	gálgánit
kálueenniš	gálueedniš
káluenni	gáluedni
kálvu	gálvu
kálágiđ	gálágit
káláttuh	gáláhttut
kálžá	gálžá
kánnu	gádnu
káppálâh	gáhppálat
kápuluh	gápulut
kárduđ	gárdut
kárgáđ	gárgát
kárvudâttâđ	gárvvudadtat
kárvuttiđ	gárvvuhttit
káránâsjuŋŋâ	gáránasjuŋŋa
káránâsmyerji	gáránasmuorji
káržudiđ	gáržudit
káržuđ	gáržut
kásániđ	gásánit
kásáttiđ	gásáhttit
kásáttuđ	gásáhttut
káttu	gáhttu
káttudiđ	gáhttudit
káttus	gáhttus
kávkkáđ	gávkkát
kávluppeeli	gávluhppeeli
kávuttiđ	gávuhttit
kávádiđ	gávádit
kááhuđ	gáhut
kááhuš	gáhuš
kááijuđ	gáijut
káálgus	gálgus
káálus	gálus
káámmár	gápmár
káárruđ	gárrut
káátu	gátu
kááđus	gáđus
káđuttâs	gáđuhttas
káđálduh	gáđáldut
káđáldâs	gáđáldas
käcci	gáhcci
kädisergi	gádisergi
kähtee	gáhtei
kähvi	gáhvi
käibi	gáibi
käibidiđ	gáibidit
kälbinjune	gálbinjuni
käldee	gáldei
käldeečujos	gáldeečujos
källee	gállei
kännyk	gádnyk
kärbisheivi	gárbisheivi
kärbisruátu	gárbisroatu
kärdi	gárdi
kärigâš	gárigaš
kärŋi-	gárŋi-
kärŋiluđ	gárŋilut
kärži	gárži
käržidiđ	gáržidit
käskeečuáimâš	gáskeečoaibmaš
käskistiđ	gáskistit
kässeekeđgi	gásseekeđgi
kässi	gássi
kässipeeci	gássipeeci
kästittiđ	gástihttit
kästiđ	gástit
kättiergi	gáhtteargi
kävildiđ	gávildit
kävilâššâđ	gávilaššat
kävni	gávdni
kävnittem	gávdnihtten
kävppalmai	gávppalbmai
kävppi	gávppi
kävppijâs	gávppijas
käzzi	gázzi
käädis	gádis
käägis	gágis
käähvih	gáhvit
käälis	gális
käämis	gámis
käärbis	gárbis
käärgis	gárgis
käärig	gárit
kääskih	gáskit
käävci	gávci
käävcis	gávcis
kääđir	gáđir
käđirdiđ	gáđirdit
käškimčuáimâš	gáikimčoaibmaš
käškirčuáimâš	gáikirčoaibmaš
käžžimpeeli	gážžimpeeli
laaddâg	láddat
laaddâh	láddat
laahâ	láha
laaiđâs	láiđas
laannjâđ	lánnjat
laannâđ	ládnat
laapâs	lápas
laasâ	lása
laaviđ	lávit
laavlâ	lávla
laavlâčuánjá	lávlačoanjá
laavlâčuáŋá	lávlačoaŋá
laavtâs	lávtas
laađâ	láđa
laađâs	láđas
laađđâđ	láđđat
labdastâh	labdastat
labdeđ	labdet
labdos	labdos
laddiittâh	laddiihttat
laddâđ	laddat
laggâ	lagga
laggâstággu	laggastággu
lahcâ	lahca
lahhaaš	lahháš
lahteđ	lahtet
lahtos	lahtos
lahtâdiđ	lahtadit
lahtân	lahtan
lahtâvuotâ	lahtavuohta
lahtâđ	lahtat
laijiđ	laijit
laitâččâttâđ	laitahččadtat
laiđiittâs	laiđiihttas
laiđiđ	laiđit
lakka	lahkka
lakkađ	lahkkat
lakke	lahkki
lakkiittiđ	lahkkiihttit
lakknub	lakknut
lakkuđ	lahkkut
lam	lan
lam vaaibâs	lam váibas
lammâšuđ	lapmašut
lamppu	lamppu
landiđ	landit
lanjâsiđ	lanjasit
lanjâstiđ	lanjastit
lanne	ladni
lanâdâttâđ	lanadadtat
lappuustiđ	lahppustit
lappuustâllâđ	lahppustallat
lappuđ	lahpput
lappâd	lahppat
lappâsist	lahppasist
lapse	laksi
lapsum	lakson
larmâ	larbma
larmâdiđ	larbmadit
lasaniđ	lasanit
lasattâs	lasahttas
lase	lasi
lasehuámášuttem	lasehoamášuhtten
lasettiđ	lasehttit
lasniđ	lasnit
lastađ	lastat
lastiđ	lastit
lasâlijne	lasalijni
lasâmield	lasamealt
lasâräigi	lasaráigi
latkiittiđ	latgiihttit
latkiš	latgiš
lattim	lahttin
lattiđ	lahttit
lavdâđ	lavdat
lavjâttiđ	lavjadtit
lavkke	lavkki
lavkkiittâh	lavkkiihttat
lavkkiđ	lavkkit
lavkkâ	lavkka
lavliistâllâđ	lavliistallat
lavnjekuáti	lavnjekoati
lavnjođ	lavnjot
lavviđ	lavvit
lavâdâs	lavadas
lavâlâš	lavalaš
lavđâ	lavđa
lavŋekuáti	lavŋekoati
lađâsijn	lađasijn
lađâsist	lađasist
lađâstiđ	lađastit
lađâsááid	lađasáit
laŋgânem	laŋganen
laŋkkiđ	laŋkkit
laŋŋiđ	laŋŋit
lašmâd	lašmat
lebbiđ	lebbit
lebbâniđ	lebbanit
leddiđ	leddit
leddâniđ	leddanit
ledâgiđ	ledagit
leehi	leahi
leeibâšk	leaibašk
leeilâ	leaila
leeji	leaji
leenâ	leana
leevvâd	leavvat
leeđi	leađi
leggistiđ	leggistit
leggistâttâđ	leggistadtat
lehâstiđ	lehastit
leiccidiđ	leihccidit
leihâšiđ	leihašit
leikkii	leihkkii
leikkâ	leihkka
leilâ	leila
leirâ	leira
leirâstâllâđ	leirastallat
lekittâs	lekihttas
lekkâ	lehkka
lekkâsiđ	lehkkasit
lekkâđ	lehkkat
lemniđ	lemnit
lendittiđ	lendihttit
lendiđ	lendit
lennjiistiđ	lennjiistit
levâniđ	levanit
levâttiđ	levadtit
leđe	leđi
leškiistiđ	leikiistit
leškiđ	leikit
libžádiđ	libžádit
libžáđ	libžát
lieggiđ	leaggit
lieggâniđ	leagganit
liegistiđ	leagistit
liegâdiđ	leagadit
liegâs	leagas
liekkičielgi	leahkkičealgi
liemâ	leama
liemâstiđ	leamastit
lieppi	leahppi
lievgi	leavgi
lieđvi	leađvi
liggoluđ	liggolut
lihmiđ	lihmit
lihmádittiđ	lihmádihttit
lihmádoh	lihmádot
lihâdem	lihaden
lihâdiđ	lihadit
lihâstâs	lihastas
lihâttiđ	lihadtit
lihâttuđ	lihadtut
liijká	liijká
liijkás	liijkás
liivzâs	liivzas
liivâh	liivat
lijgešodâlmâs	lijgešodalbmas
lijgodiđ	lijgodit
lijgođ	lijgot
lijkkuuttettee	lijkkuhttehttei
lijkkuđ	lijkkut
lijme	lijmi
lijmá	lijmá
lijne	lijni
likkođ	lihkkot
likkuš	lihkkuš
likkâmčalme	lihkkamčalbmi
likkâđ	lihkkat
likâttiđ	likadtit
limppođ	limppot
lines	lines
linestiđ	linestit
linjâšauto	linjašauto
lippođ	lihppot
lippu	lihppu
lippustággu	lihppustággu
lipčeđ	lipčet
lirijdiđ	lirijdit
lirrân	lirran
listo	listo
listá	listá
litodâttâđ	litodadtat
litte	lihtti
livgâsiđ	livgasit
livkettiđ	livkehttit
livkkâliđ	livkkalit
livvoođ	livvot
livvuuttiđ	livvuhttit
livvuđ	livvut
livvâdiđ	livvadit
livzestiđ	livzestit
livârdiđ	livardit
livđe	livđi
livđuđ	livđut
liäbbud	leabbut
liäddud	leaddut
liädduđ	leaddut
liägus	leagus
liähmus	leahmus
liähtu	leahtu
liäibuđ	leaibut
liäjá	leajá
liäjádiđ	leajádit
liäksu	leaksu
liäpu	leapu
liäpčud	leapčut
liävháttiđ	leavháhttit
liävuttem	leavuhtten
liävuttuddâđ	leavuhttuddat
liävuttuđ	leavuhttut
liävvud	leavvut
liävvuđ	leavvut
liäčániđ	leačánit
liäđáhittiđ	leađáhihttit
liäškuliđ	leaikulit
liäškuđ	leaikut
liäškásiđ	leaikásit
liäškáđ	leaikát
liđijdiđ	liđijdit
liške	liiki
liškekonnâ	liikekodna
liškeloh	liikelot
liškesoovsâ	liikesovsa
liškáduđ	liikádut
lobâdiđ	lobadit
loccâ	lohcca
loddiđ	loddit
loddááš	loddáš
lodejyelgi	lodejuolgi
lodekozzâ	lodekozza
lodeluoddâ	lodeluodda
lodetikke	lodetihkki
loggeđ	logget
lohhee	lohhei
lohhiđ	lohhit
lohtuđ	lohtut
lohtâ	lohta
loigâniđ	loiganit
loigâttâh	loigadtat
loigâđ	loigat
loijoođ	loijot
loje	loji
lojodiđ	lojodit
lokke	lohkki
lones	lones
lonestiđ	lonestit
lonje	lonji
lonjo	lonjo
lonnjoođ	lonnjot
lonnjâ	lonnja
lonnoom	lodnon
lonnoođ	lodnot
lonottiđ	lonohttit
lonástâs	lonástas
loommâđ	lopmat
loopâst	lopast
loovdâ	lovda
loovnâ	lovdna
loovnâs	lovdnas
loovtâ	lovta
loová	lová
loppiittiđ	lohppiihttit
loppiittâs	lohppiihttas
loppim-	lohppim-
loppimmielkki	lohppipmealki
loppâ	lohppa
loppâniđ	lohppanit
loppâsiđ	lohppasit
loptosist	loktosist
loptosân	loktosan
lopâlávt	lopalávt
lopâttiđ	lopadtit
lopâttâs	lopadtas
loskeđ	losket
loskâđ	loskat
lossoođ	lossot
lostâ	losta
lostâväldimpieggâ	lostaváldimpeagga
losâliđ	losalit
lote	loti
lovdâččiđ	lovdahččit
lovdâšuđ	lovdašut
love	lovi
loves	loves
lovkkâliđ	lovkkalit
lovniđ	lovdnit
lovottâh	lovohttat
lovottâhvuárkká	lovohttahvoarká
lovvááš	lovváš
lovádâs	lovádas
loválâš	loválaš
lozzâniđ	lozzanit
ložžiistiđ	ložžiistit
ložžiđ	ložžit
luddiđ	luddit
luggo	luggo
luhhii	luhhii
luholâš	luholaš
luhostuđ	luhostut
luhottem	luhohtten
luhottesvuotâ	luhohttesvuohta
luhottuđ	luhohttut
luhâlâhčâđ	luhalakčat
luhâmettum	luhamehtton
luisteliđ	luistelit
lukko	luhkko
lukkuđ	luhkkut
lukkuš	luhkkuš
luksâdiđ	luksadit
lulláđ	lullát
lummo	lupmo
lummâ	lupma
lunne	ludni
lunnees	ludnees
lunnáád	ludnát
lunnáán	ludnán
luobdâđ	luobdat
luobâl	luobal
luoddiistâllâđ	luoddiistallat
luoddiđ	luoddit
luoddâ	luodda
luoddânem	luoddanen
luodâstiđ	luodastit
luohtâ	luohta
luohčâđ	luokčat
luoihâs	luoihas
luoihâttiđ	luoihadtit
luoikkâđ	luoihkkat
luoimâđ	luoibmat
luokka	luohkka
luommiđ	luopmit
luonniđ	luodnit
luoskâniđ	luoskanit
luostâg	luostat
luovviđ	luovvit
luovâniđ	luovanit
luovâs	luovas
luovâsmiđ	luovasmit
luovâspáárnáš	luovaspárnáš
luovâsvuotâ	luovasvuohta
luovâsvyeje	luovasvuoji
luođiđ	luođit
luođâ	luođa
luoštuđ	luoitut
luptiđ	luktit
luptâ	lukta
luptâniđ	luktanit
luptâstâh	luktastat
luskuđ	luskut
lusme	lusmi
lussâd	lussat
lussâdvuotâ	lussadvuohta
lustiđ	lustit
lusto	lusto
lustottem	lustohtten
luuhâmoornig	luhamornit
luuhâđ	luhat
luuppâđ	luhppat
luusâ	lusa
luusâd	lusat
luusân	lusan
luusâs	lusas
luuvâ	luva
luvveđ	luvvet
luvâhánnáá	luvahádná
luvâstiđ	luvastit
luvâttuh	luvadtut
luvâttâllâm	luvadtallan
luádduđ	loaddut
luáduttâh	loaduhttat
luáidu	loaidu
luákki	loahkki
luákká	loahkká
luámi	loami
luámu	loamu
luánáttuđ	loanáhttut
luáptiđ	loaktit
luási	loasi
luátis	loatis
luátu	loatu
luávdiliđ	loavdilit
luávdiđ	loavdit
luávittiđ	loavihttit
luávkkiđ	loavkkit
luávkku	loavkku
luáváttus	loaváhttus
luáváttâh	loaváhttat
luáčániđ	loačánit
luáđhus	loađhus
luáđjá	loađjá
luáŋkkuđ	loaŋkkut
luáštádâttâđ	loaitádadtat
luážus	loažus
luážži	loažži
luččâtavdâ	luhččadavda
luđgáđ	luđgát
luđŋâniđ	luđŋanit
luŋkke	luŋkki
luŋkkepelji	luŋkkepelji
luŋâniđ	luŋanit
lyeme	luomi
lyeni	luoni
lyenilitte	luonilihtti
lyeppih	luohppit
lyevdi	luovdi
lyevi	luovi
lyeštiđ	luoitit
lábbásâš	lábbásaš
láddu	láddu
lággu	lággu
lágádâs	lágádas
láhupieggâ	láhupeagga
láirá	láirá
láittádâttâđ	láihttádadtat
láivudiđ	láivudit
lápčud	lápčut
lápčániđ	lápčánit
lássá	lássá
lástu	lástu
lávdástem	lávdásten
lávguääldis	lávguáldis
lávguđ	lávgut
lávkkuđ	lávkkut
lávlumjuávkku	lávlumjoavkku
lávluđ	lávlut
lávurdâh	lávurdat
lávárdâh	lávárdat
lávástâh	lávástat
lááitus	láitus
lááju	láju
láámmuđ	lápmut
lááppuđ	láhpput
láássáš	lássáš
láávvuđ	lávvut
láškuttâllâđ	láikuhttallat
láškuđ	láikut
lášká	láiká
láškášiđ	láikášit
lášmuttâllâm	lášmuhttallan
läbži	lábži
läbžiloje	lábžiloji
läbžimáátu	lábžimátu
läbžipallee	lábžipallei
läddilâš	láddilaš
lähji	láhji
läigi	láigi
läittilistiđ	láihttilistit
läittiđ	láihttit
läjidiđ	lájidit
läpittiđ	lápihttit
lättee	láhttei
lätteeráánu	láhtteeránu
lävgistiđ	lávgistit
lävvid	lávvit
lävvidiđ	lávvidit
lääbis	lábis
lääbžipeeli	lábžipeeli
läämi	lámi
lääni	láni
läätis	látis
läättinrassi	láhttinrassi
lääđi	láđi
lääđis	láđis
läđisváimusâš	láđisváibmusaš
läđđee	láđđei
läški	láiki
maadâ	máda
maadâpieggâ	mádabeagga
maahâ	máha
maaijuv	máijuv
maainâs	máinas
maaizâs	máizas
maajeeb	májeet
maajeeld	májeelt
maajeeldceehis	májeeldceehis
maajeeldhaŋgâ	májeeldhaŋga
maajeeldpuáttee	májeeldpoahttei
maajooš	májoš
maakkan	máhkkan
maaldâs	máldas
maalâ	mála
maannâđ	mádnat
maassâd	mássat
maasâd	másat
maavâ	máva
maađij	máđij
maaŋgkerdanneem-	máŋgkerdadneem-
maaŋgâ-	máŋga-
maaŋgâlágán	máŋgalágán
maaŋgâmuáđusâš	máŋgamoađusaš
maaŋgâmuđusâš	máŋgamuđusaš
maaŋgâs	máŋgas
maaššiđ	máššit
maaššâl	máššal
maaššâđ	máššat
mabdem	mabden
macâttiđ	macadtit
madduuh	maddut
maddâgâs	maddagas
madrâs	madras
madâppieggâ	madabpeagga
madârákku	madaráhkku
magasin	magasin
maggaar	maggár
maggaargin	maggárgin
mahkeđ	mahget
maht	maht
mahte	mahti
mahten	mahten
mai	mai
maid	mait
maigârdeijee	maigardeijei
maijuu	maiju
mainâstiđ	mainastit
mainâšiđ	mainašit
maivâ	maiva
maiziđ	maizit
maizâđ	maizat
majebáš	majebáš
majediđ	majedit
majemustáá	majemustá
majemuš	majemuš
majettuddâđ	majehttuddat
majettuđ	majehttut
makkuu	mahkku
makkuđ	mahkkut
maksuđ	maksut
maldâđ	maldat
malli	malli
mane	mani
maneks	maneks
manje	manji
manjepeeli	manjepeeli
mannekiin	madnekiin
manneš	madneš
mannjeed	mannjeet
manâdiđ	manadit
manâttâttâđ	manadtadtat
markkân	markan
markkânmaainâs	markanmáinas
markkânsaahâ	markansáha
markkânâššâđ	markanaššat
masa	masa
materiaal	materiál
materiaallâš	materiállaš
mattâđ	mahttat
mavređ	mavret
mavsâttiđ	mavsadtit
mađe	mađi
mađhâšeijee	mađhašeijei
mađhâšiđ	mađhašit
maŋa	maŋa
maŋadist	maŋadist
maŋaniđ	maŋanit
maŋanuđ	maŋanut
maŋas	maŋas
maŋediđ	maŋedit
maŋelub	maŋelut
maŋeláhháá	maŋeláhhá
maŋeláá	maŋelá
maŋgii	maŋgii
maŋgâ	maŋga
maŋŋaal	maŋŋál
maŋŋaalsis	maŋŋálsis
mecci	mehcci
meccuđ	mehccut
meddiđ	meddit
meehkâs	meahgas
meeli	meali
meendu	meandu
meeri	meari
meeris	mearis
meerris	mearris
meeđđiđ	meađđit
mehkâliđ	mehgalit
meid	meit
meidiđ	meidit
meinađ	meinat
melguu	melgu
melguui	melgui
melgâd	melgat
melodia	melodia
mere	meri
merettem	merehtten
merhâšem	merhašen
merhâšijjee	merhašijjei
merhâšittee	merhašihttei
merhâšiđ	merhašit
merhâšume	merhašumi
meridiđ	meridit
merkkim	merkin
merkkiđ	merkit
merkkuđ	merkut
merkkâ	merka
merkkâdiđ	merkadit
merâriddo	merariddo
merâtuhtuu	meraduhtu
mestâ	mesta
meteor	meteor
mevristiđ	mevristit
međkki	međkki
miehtâ	meahta
miehâr	meahar
miehâđ	meahat
miekki	meahkki
mieldi	mealdi
mieldis	mealdis
mielgâs	mealgas
mielgâtähti	mealgadáhti
mielkki	mealki
mielli	mealli
mielâ	meala
mielâsâš	mealasaš
mielâttuđ	mealadtut
mielâvääni	mealaváni
mieskii	measkii
mieskâs	measkas
mieskâđ	measkat
miestâdiđ	meastadit
miestâs	meastas
miestâđ	meastat
mietimái	meatimái
mieđediđ	meađedit
mihheen	mihheen
mii	mii
miinii	miinii
miinstâr	miinstar
mij	mij
millođ	millot
minttu	minttu
mirhâttiđ	mirhadtit
mirkkiđ	mirkit
mirkkâ	mirka
mirkkâdiđ	mirkadit
mis	mis
missiđ	missit
misso	misso
mittediđ	mihttedit
mitto	mihtto
mittomeeri	mihttomeeri
miäcásteijee	meacásteijei
miäddádiđ	meaddádit
miähkáđ	meahgát
miähástâh	meahástat
miäháttiđ	meaháhttit
miäidáttuvah	meaidáhttuvat
miäináđ	meainát
miäldus	mealdus
miäldád	mealdát
miäldálâs	mealdálas
miäldán	mealdán
miälgui	mealgui
miälgus	mealgus
miälluđ	meallut
miälástiđ	mealástit
miändu	meandu
miärkkum	mearkon
miärkkuđ	mearkut
miärkká	mearká
miärkká-	mearká-
miäruštâllâđ	mearuitallat
miärádâs	mearádas
miäsmuđ	measmut
miästájuđ	meastájut
miästáđ	meastát
miätá	meatá
miäđuštiđ	meađuitit
miäđáápeln	meađápeln
moddii	moddii
moggediđ	moggedit
mohtâ	mohta
mohtâdiđ	mohtadit
mohástâllâđ	mohástallat
moijooh	moijot
moijáđ	moiját
moive	moivi
mokke	mohkki
mokkádistiđ	mohkkádistit
mollâ	molla
molsođ	molsot
molârdiđ	molardit
mon	mon
mondiet	mondeat
monmit	monmit
monnjâkiistâ	monnjagiista
monnjâpurrâmâš	monnjaburramaš
monâdiđ	monadit
monâliđ	monalit
monâttittee	monadtihttei
monâttiđ	monadtit
moollâđ	mollat
moolâ	mola
moonjiš	monjiš
moonnâđ	modnat
moovsâš	movsaš
moovtig	movtit
more	mori
morettiđ	morehttit
morrumjieŋâ	morrumjeaŋa
morruđ	morrut
mortottiđ	mortohttit
morániđ	moránit
morâttâh	moradtat
morčes	morčes
morčessuonâ	morčessuona
moskod	moskot
moskodiđ	moskodit
moskos	moskos
moskottiđ	moskohttit
mostođ	mostot
motomin	motomin
mottâ	mohtta
movssiđ	movssit
movstáskiđ	movstáskit
movtijdiđ	movtijdit
mođárdittiđ	mođárdihttit
muddo	muddo
muddáág	muddát
mudágistiđ	mudágistit
mudágâš	mudágaš
mudârdiđ	mudardit
mugâgiđ	mugagit
muh	mut
muide	muidi
muidego	muidego
muigâgiđ	muigagit
muigâniđ	muiganit
muijâsiđ	muijasit
muijâsâddâđ	muijasaddat
muikku	muihkku
muiviđ	muivit
muivâšum	muivašon
muivâšuđ	muivašut
mukkâsiđ	muhkkasit
muldesäplig	muldesáplit
mulijdiđ	mulijdit
mullân	mullan
mullârdiđ	mullardit
mulže	mulži
mulžekeđgi	mulžekeđgi
mulžáttiđ	mulžáhttit
mun	mun
munejuurdâ	munejurda
muoi	muoi
muoldâg	muoldat
muorrii	muorrii
muorriđ	muorrit
muorâ	muora
muorâid	muorait
muorâluáddumsaje	muoraloaddumsaji
muorâsaje	muorasaji
muorâsáigu	muorasáigu
muorâttem	muoradten
muorâčeppi	muoračehppi
muottuuttem	muohttuhtten
muottuđ	muohttut
muotâ	muota
muotâkierâ	muotageara
muotâččiđ	muotahččit
muovlâ	muovla
muođđâl	muođđal
muošnu	muošnu
murduđ	murdut
murijdiđ	murijdit
murriš	murriš
murâšlâš	murašlaš
murâštiđ	muraitit
muršâ	murša
murššâ	muršša
musikkár	musihkkár
must	must
mut	mut
mutteđ	muhttet
muttuđ	muhttut
muulsâiähtu	mulsaeahtu
muulsâiävtulâš	mulsaeavtulaš
muuneeld	muneelt
muurâš	muraš
muuttâđ	muhttat
muuzzig	muzzit
muuzzigjievjâ	muzzigjeavja
muuzzigčuoivâg	muzzigčuoivat
muvgâgiđ	muvgagit
muvrediđ	muvredit
muvzáđ	muvzát
muáccuđ	moahccut
muáculiđ	moaculit
muáddi	moaddi
muáddá	moaddá
muádis	moadis
muáijuđ	moaijut
muáittiđ	moaihttit
muáitus	moaitus
muáiđoo-	moaiđo-
muálhujuolgij	moalhujuolgij
muálkki	moalki
muálkkiluttiđ	moalkiluhttit
muálkkuđ	moalkut
muálkkásiđ	moalkásit
muálkkáá	moalká
muári	moari
muárráá	moarrá
muáráskiđ	moaráskit
muáráttuđ	moaráhttut
muássáá	moassá
muásá	moasá
muáti	moati
muáttoo	moahtto
muátástâllâđ	moatástallat
muávruđ	moavrut
muáđuh	moađut
muáđá	moađá
muáđđâl	moađđal
mučásmiđ	mučásmit
mučâsmiđ	mučasmit
mučâšiđ	mučašit
muččáđ	muhččát
muččâd	muhččat
muččâdvuotâ	muhččadvuohta
muččâdávt	muhččadávt
mušteđ	muitet
mušto	muito
muštottiđ	muitohttit
muštottuđ	muitohttut
muštáđ	muitát
muštâliđ	muitalit
myeiđi	muoiđi
myelliđ	muollit
myenster	muonster
myerji	muorji
myerssee	muorssei
myesi	muosi
myesittem	muosihtten
myessid	muossit
máccuđ	máhccut
máddá	máddá
máddániđ	máddánit
máhđulâš	máhđulaš
máksu	máksu
máksá	máksá
málástâllâđ	málástallat
mánudâš	mánudaš
mánuppaje	mánuhppaji
mánuvaajâs	mánuvájas
mánuvuáđu	mánuvoađu
mánálâš	mánálaš
márdu	márdu
márfuđ	márfut
máttu	máhttu
máttáátteijee	máhttáhtteijei
máttááttiđ	máhttáhttit
máttááttuđ	máhttáhttut
máttááttâllâđ	máhttáhttallat
máttááttâs	máhttáhttas
máttáđ	máhttát
mávsulâš	mávsulaš
mávutteijee	mávuhtteijei
mááccuh	máhccut
mááddáš	máddáš
máádás	mádás
mááhu	máhu
mááinuh	máinut
mááináš	máináš
máánnud	mádnut
máánu	mánu
máánuniäljádâs	mánunealjádas
mááŋgus	máŋgus
máášu	mášu
máđhálâš	máđhálaš
mášuttuđ	mášuhttut
mäcci	máhcci
mäddeeb	máddeet
mäddi	máddi
mäddin	máddin
mädibâš	mádibaš
mädimus	mádimus
mäihli	máihli
mäini	máini
mäinittem	máinihtten
mäksiđ	máksit
mälisteijee	málisteijei
mälistiđ	málistit
mäličääci	máličáci
mälttiđ	máltit
mänidiđ	mánidit
märfi	márfi
mätki	mátgi
mätkipuhelin	mátgipuhelin
mättim	máhttin
mättiđ	máhttit
mävsittiđ	mávsihttit
määddib	máddit
määli	máli
määlis	mális
määđhi	máđhi
määššil	máššil
na	na
naa	ná
naabur	nábur
naagâs	nágas
naaijâđ	náijat
naalâh	nálat
naappâl	náhppal
naarvâ	nárva
naavcah	návcat
naba	naba
nabai	nabai
nabdastâllâđ	nabdastallat
nabdem	nabden
nabdestiđ	nabdestit
nabdeđ	nabdet
naggiđ	naggit
naggâ	nagga
naggâsávt	naggasávt
nahcii	nahcii
nahciđ	nahcit
nahcâ	nahca
nahettiđ	nahehttit
nahettâttâđ	nahehttadtat
nakkaniđ	nahkkanit
nalgâniđ	nalganit
nalgâđ	nalgat
nalâčuárvi	nalačoarvi
nanodiđ	nanodit
nanos	nanos
nanosmittiđ	nanosmihttit
nanošiđ	nanošit
napâlâššâđ	napalaššat
narriđ	narrit
natriumkarbonaat	natriumgarbonát
navcâttem	navcadten
navcâttuđ	navcadtut
navliittuđ	navliihttut
navvoođ	navvot
neeljis	nealjis
neepi	neapi
nelgi	nelgi
nelji	nelji
neljii	neljii
neppir	nehppir
nevli	nevli
nevttiđ	nevttit
niddeđ	niddet
nieidiđ	neaidit
nieidâ	neaida
nieidâpärni	neaidabárni
niekki	neahkki
nierâ	neara
nierâuáivi	nearaoaivi
nievri	neavri
nievridiđ	neavridit
nievriht	neavriht
nievt	neavt
niirrâđ	niirrat
niisu	niisu
nijbesääni	nijbesáni
nijsâ	nijsa
nijtteđ	nijttet
nijtto	nijtto
nirráá	nirrá
nirvođ	nirvvot
niske	niski
nisonistiđ	nisonistit
nissoon	nisson
nissoođ	nissot
nistettiđ	nistehttit
nisteđ	nistet
nivkkeđ	nivkket
nivkkođ	nivkkot
nivsettiđ	nivsehttit
niälguđ	nealgut
niälgádiđ	nealgádit
niälgáá	nealgá
niävrániđ	neavránit
niävráá	neavrá
niävttár	neavttár
niävvu	neavvu
niävvuđ	neavvut
niŋálâs	niŋálas
njaahâđ	njáhat
njaajâ	njája
njaalgâsiähá	njálgaseahá
njaammâđ	njápmat
njaavvâl	njávval
njaddee	njaddei
njaddeđ	njaddet
njaddo	njaddo
njaddodiđ	njaddodit
njadestiđ	njadestit
njados	njados
njadostiđ	njadostit
njagottiđ	njagohttit
njahče	njakči
njalahistiđ	njalahistit
njalahâs	njalahas
njalaniđ	njalanit
njaldeđ	njaldet
njale	njali
njalhostiđ	njalhostit
njalloođ	njallot
njalmušiđ	njalbmušit
njalpettiđ	njalpehttit
njamasiđ	njamasit
njamauáiváš	njamaoaiváš
njamma	njapma
njammeepärni	njapmeepárni
njarbisuáivi	njarbisoaivi
njarbâd	njarbat
njargâ	njarga
njave	njavi
njavhâstiđ	njavhastit
njavkke	njavkki
njavkkâđ	njavkkat
njavâttiđ	njavadtit
njeeccih	njeahccit
njeeccihmiehtâ	njeahccihmeahta
njeeijiđ	njeaijit
njeeijâm	njeaijan
njeeijâđ	njeaijat
njeeri	njeari
njeidiđ	njeidit
njeđgâđ	njeđgat
njibžettiđ	njibžehttit
njibžeđ	njibžet
njieccâđ	njeahccat
njiesâs	njeasas
njihe-	njihe-
njihhood	njihhot
njihinjistiđ	njihinjistit
njihânjistiđ	njihanjistit
njiihâđ	njiihat
njiittâđ	njiihttat
njilkkâliđ	njilkalit
njirro	njirro
njirtottâh	njirtohttat
njirttođ	njirtot
njiskođ	njiskot
njiviččenkálgu	njivihččenkálgu
njivkkeđ	njivkket
njivle	njivli
njivlođ	njivlot
njivláá	njivlá
njizzeđ	njizzet
njiäládiđ	njealádit
njiäpcuđ	njeapcut
njiäpčuttiđ	njeapčuhttit
njiäpčááttiđ	njeapčáhttit
njiäšku	njeaiku
njižže	njižži
njobžâ	njobža
njobžâdâh	njobžadat
njocârdiđ	njocardit
njolpettiđ	njolpehttit
njolpáttiđ	njolpáhttit
njomâttâh	njomadtat
njooccâđ	njohccat
njoommâđ	njopmat
njoomâhkálgu	njomahgálgu
njoođâ	njođa
njoođâlm	njođaln
njoppâsist	njohppasist
njorijdiđ	njorijdit
njorttâdiđ	njortadit
njorttâđ	njortat
njoveldiđ	njoveldit
njovhâttiđ	njovhadtit
njočârdiđ	njočardit
njuhčâ	njukča
njuigo	njuigo
njuigáđ	njuigát
njulpettiđ	njulpehttit
njulppáđ	njulpát
njulppâliđ	njulpalit
njulppâsiđ	njulpasit
njulččel	njulččel
njulččáđ	njulččát
njune	njuni
njuneh	njunet
njuneh láá toppum	njuneh lá tohppon
njunekeeči	njunekeeči
njuneräigi	njuneráigi
njunetubbáák	njunetubbák
njunevuálástiđ	njunevoalástit
njunečuoškâ	njunečuoika
njunnáá	njudná
njunoštuáhtár	njunoitoahtár
njunáduđ	njunádut
njuoccâh	njuohccat
njuoccâđ	njuohccat
njuolgist	njuolgist
njuolgiđ	njuolgit
njuolgâ	njuolga
njuolgâd	njuolgat
njuolgâdus	njuolgadus
njuolgâdâs	njuolgadas
njuolgâs	njuolgas
njuolgâčuárvi	njuolgačoarvi
njuolâ	njuola
njuolâs	njuolas
njuolâviini	njuolaviini
njuopâ	njuopa
njuordâđ	njuordat
njuorrâđ	njuorrat
njuorâ	njuora
njuorâhpáárnáš	njuorahbárnáš
njuorâhvuásáš	njuorahvoasáš
njuorâs	njuoras
njuorâsmiđ	njuorasmit
njuoskâdiđ	njuoskadit
njuoskân	njuoskan
njuoskâs	njuoskas
njuoskâstiđ	njuoskastit
njuoskâđ	njuoskat
njuoskâšiđ	njuoskašit
njuottâđ	njuohttat
njuovvâmlágádâs	njuovvamlágádas
njuovvâđ	njuovvat
njuovâdiđ	njuovadit
njuovâdâh	njuovadat
njuovâttuđ	njuovadtut
njuovčâ	njuovča
njuppâsiđ	njuhppasit
njurgiđ	njurgit
njurgođ	njurgot
njuunij	njunij
njuuppâh	njuhppat
njuuvdâs	njuvdas
njuvgâd	njuvgat
njuáci	njoaci
njuággá	njoaggá
njuálgu-	njoalgu-
njuálgus	njoalgus
njuálgusárgum	njoalgusárgon
njuálluđ	njoallut
njuáludiđ	njoaludit
njuáludâttâđ	njoaludadtat
njuálččáá	njoalččá
njuámmootavdâ	njoapmotavda
njuámmuđ	njoapmut
njuámudiđ	njoamudit
njuámuttiđ	njoamuhttit
njuámádiđ	njoamádit
njuárguđ	njoargut
njuári	njoari
njuárusteijee	njoarusteijei
njuárustiđ	njoarustit
njuárustâllâđ	njoarustallat
njuárádâh	njoarádat
njuásiht	njoasiht
njuáskáduh	njoaskádut
njuávih	njoavit
njuávihvuásáš	njoavihvoasáš
njuškiđ	njuikit
njuškottiđ	njuikohttit
njuškottâh	njuikohttat
njuškođ	njuikot
njyergis	njuorgis
njyeskistiđ	njuoskistit
njyevvee	njuovvei
njábbáá	njábbá
njáhháá	njáhhá
njálgudiđ	njálgudit
njálguđ	njálgut
njálgáh	njálgát
njálgásmiđ	njálgásmit
njálgásávt	njálgásávt
njálmuđ	njálbmut
njálmádâh	njálbmádat
njápčááttiđ	njápčáhttit
njárbudiđ	njárbudit
njárbuđ	njárbut
njávguđ	njávgut
njášku	njáiku
njäbbi	njábbi
njäidi	njáidi
njälmi	njálbmi
njävgiđ	njávgit
njävhistiđ	njávhistit
njävli	njávli
njäähi	njáhi
njäälgis	njálgis
no	no
nobduđ	nobdut
nocce	nohcci
noccedâttâđ	nohccedadtat
noccáá	nohccá
noddiđ	noddit
nohhee	nohhei
nohhááttiđ	nohháhttit
nohádistiđ	nohádistit
nohádittiđ	nohádihttit
nohádiđ	nohádit
noigâđ	noigat
nokko	nohkko
nolládiđ	nolládit
nolláđ	nollát
nolppokussâ	nolpokussa
nommâ	nopma
nommâdiđ	nopmadit
nommâloppâ	nopmalohppa
nomâlâs	nomalas
nomâttem	nomadten
nomâttiđ	nomadtit
nomâttâs	nomadtas
nonniđ	nodnit
nooijâđ	noijat
noollâđ	nollat
noppe	nohppi
noppânjavkke	nohppanjavkki
nore	nori
norkkâ	norka
noskettiđ	noskehttit
noskáttiđ	noskáhttit
novdâ	novda
nubbe	nubbi
nubbááš	nubbáš
nubepel	nubepel
nubepeln	nubepeln
nubetove	nubetovi
nubijdis	nubijdis
nubás	nubás
nubásmittiđ	nubásmihttit
nubásmiđ	nubásmit
nubástuđ	nubástut
nuhhuđ	nuhhut
nuhostiđ	nuhostit
nuhostâh	nuhostat
nuhtán	nuhtán
nuhâstiđ	nuhastit
nuijáá	nuijá
nuje	nuji
nukkosiđ	nuhkkosit
nukkâđ	nuhkkat
nulhediđ	nulhedit
nuládiđ	nuládit
nuolluđ	nuollut
nuollâđ	nuollat
nuolâsiđ	nuolasit
nuorbâđ	nuorbat
nuorttii	nuortii
nuorttii-	nuortii-
nuorttâ	nuorta
nuorttân	nuortan
nuortâs	nuortas
nuorâ	nuora
nuorâsmittiđ	nuorasmihttit
nuorâšiđ	nuorašit
nuoskušiđ	nuoskušit
nuottii	nuohttii
nuottâ	nuohtta
nuotâlâš	nuotalaš
nurde	nurdi
nurdâstâllâđ	nurdastallat
nurrâluđ	nurralut
nursse	nurssi
nursseluđ	nursselut
nurssom	nursson
nurssođ	nurssot
nurvodâttâđ	nurvvodadtat
nurvostiđ	nurvvostit
nurvottâttâđ	nurvvohttadtat
nurvođ	nurvvot
nurváástâllâđ	nurvástallat
nurâdiđ	nuradit
nurâdâttâđ	nuradadtat
nurâliđ	nuralit
nuske	nuski
nutkâliđ	nutgalit
nutkâđ	nutgat
nuttâliđ	nuhttalit
nuttâluđ	nuhttalut
nutâgiđ	nutagit
nuubiš	nubiš
nuuhâđ	nuhat
nuurrâđ	nurrat
nuuská	nuská
nuuvt	nuvt
nuuvtko	nuvtgo
nuvgâ	nuvga
nuváhánnáá	nuváhádná
nuvâttiđ	nuvadtit
nuálusiđ	noalusit
nuáluskaamuv	noaluskámuv
nuárvi	noarvi
nuárvui	noarvui
nuárvuinjune	noarvuinjuni
nuárvádiđ	noarvvádit
nuáski	noaski
nuáskudiđ	noaskudit
nuáskus	noaskus
nuáskádâs	noaskádas
nuástiđ	noastit
nuáttuđ	noahttut
nuávlu	noavlu
nuáđi	noađi
nuáđásiđ	noađásit
nuđhâttiđ	nuđhadtit
nyeli	nuoli
nyeri	nuori
nyeski	nuoski
nyeskivuotâ	nuoskivuohta
nyevt	nuovt
nábbá	nábbá
nággu	nággu
nágáttâllâđ	nágáhttallat
nánnáá	nádná
náskál	náskál
návdoo	návdo
návduđ	návdut
návt	návt
náálu	nálu
nááppáš	náhppáš
náárááš	náráš
nähki	náhgi
näidi	náidi
näimilito	náibmilito
nälittem	nálihtten
nävdi	návdi
nävli	návli
nääli	náli
o	o
oberjâš	oberjaš
oggârâššâđ	oggaraššat
ohcii	ohcii
ohe	ohi
ohtii	ohtii
ohtiigin	ohtiigin
ohtuunis	ohtunis
ohtâ	ohta
ohtâdâh	ohtadat
ohtâgâslâš	ohtagaslaš
ohtân	ohtan
ohtâvuotâ	ohtavuohta
oinuđ	oinut
okkolostâ	ohkkolosta
okâttiđ	okadtit
oles	oles
olesolmooš	olesolbmoš
olgiš	olgiš
olgoláhháá	olgoláhhá
olgoláá	olgolá
olgooš	olgoš
olgos	olgos
olgospyehtim	olgospuohtin
oljo	oljo
oljosoráase	oljosoráasi
oljočievrâasasâš	oljočeavrásasaš
oljočievrâase	oljočeavrási
ollee	ollei
olliđ	ollit
olluv	olluv
olluvvuotâ	olluvvuohta
ollágin	ollágin
ollásávt	ollásávt
ollâgub	ollagut
ollâgumos	ollagumos
ollâmielâg	ollamealat
olmooš	olbmoš
olmoošloho	olbmošloho
olmoošmettum	olbmošmehtton
olmâ	olbma
olmânáál	olbmanál
olnâ	olna
olottimmuddo	olohttipmuddo
olssis	olssis
olssâd	olssat
olssân	olssan
olán	olán
olášuttem	olášuhtten
olâttiđ	oladtit
omo	omo
omo-	omo-
omâdâh	omadat
omâslâš	omaslaš
omâsteijee	omasteijei
omâstemkiäjus	omastemgeajus
omâttâllâđ	omadtallat
onnuđ	odnut
oobbiš	obbiš
oohtân	ohtan
ooleest	oleest
oolgiš	olgiš
ooláádmuddo	oládmuddo
oolâ	ola
oommân	opman
oomâs	omas
oordel	ordel
oornig	ornit
oornigist	ornigist
oornigân	ornigan
oovce	ovci
oovces	ovces
oovdeb	ovdet
oovdeld	ovdelt
oovdeldceehis	ovdeldceehis
oovdeldhaŋgâ	ovdeldhaŋga
oovdeldkietân	ovdeldkeatan
oovdiš	ovdiš
oovdân	ovdan
oovdânpyehtim	ovdanpuohtin
oovdânpyehtiđ	ovdanpuohtit
oovdâs	ovdas
oovdâst	ovdast
oovdâš	ovdaš
oovtnáál	ovtnál
oovtâdâh	ovtadat
oovtâkiärdán	ovtageardán
oovtâloho	ovtaloho
oovtâst	ovtast
oovtâstpargo	ovtastpargo
oođâ	ođa
oppeet	ohppeet
oppâ	ohppa
oppâđ	ohppat
opsijdiđ	oksijdit
opsâ	oksa
opâdiđ	opadit
opâtteijee	opadteijei
opâttiđ	opadtit
opâttâs	opadtas
ordo	ordo
ordâ	orda
orespeeci	orespeeci
orgaan	orgán
orjâlâškielâ	orjalaikeala
orjâlâšpiegâpeln	orjalašpeagabeln
orniistâllâđ	orniistallat
ornijdume	ornijdumi
ornijdâh	ornijdat
orniđ	ornit
oro	oro
orosistiđ	orosistit
orostistiđ	orostistit
orostittiđ	orostihttit
orostiđ	orostit
orroo	orro
orroommáášu	orropmášu
orroođ	orrot
orrâ	orra
orvâttuđ	orvvadtut
orvâđ	orvvat
oskeldiđ	oskeldit
oskeldâttâđ	oskeldadtat
osko	osko
oskoldâh	oskoldat
oskottem	oskohtten
oskottiđ	oskohttit
oskovâš	oskovaš
oskođ	oskot
ostodiđ	ostodit
ostoduđ	ostodut
ostomuorâ	ostomuora
ostâdiđ	ostadit
ostâliđ	ostalit
ostâstuđ	ostastut
ostâđ	ostat
otânâššâđ	otanaššat
ovdebist	ovdebist
ovdebáš	ovdebáš
ovdeláhháá	ovdeláhhá
ovdeláá	ovdelá
ovdemuš	ovdemuš
ovdiibel	ovdiibel
ovdláhháá	ovdláhhá
ovdánem	ovdánen
ovdániđ	ovdánit
ovdâdâs	ovdadas
ovdâháástâllâđ	ovdahástallat
ovdâhâš	ovdahaš
ovdâjuurdâ	ovdajurda
ovdâkietân	ovdageatan
ovdâkiistâ	ovdagiista
ovdâl	ovdal
ovdâlabdos	ovdalabdos
ovdâlist	ovdalist
ovdâláhháá	ovdaláhhá
ovdâláá	ovdalá
ovdâolmooš	ovdaolbmoš
ovdâskulij	ovdaskulij
ovdâskuávlui	ovdaskoavlui
ovdâspiergim	ovdaspeargin
ovdâsteijee	ovdasteijei
ovdâvepsi	ovdaveksi
ovdâšeh	ovdašet
ovttuu	ovttu
ovtâskâs	ovtaskas
ovtâspargo	ovtaspargo
ovtâttem	ovtadten
ovtâttâh	ovtadtat
oŋâttuššâđ	oŋadtuššat
oŋâttâššâđ	oŋadtaššat
oškâstiđ	oikastit
ožijduđ	ožijdut
paa	bá
paaccâh	báhccat
paahus	báhus
paaimân	báibman
paajaaš	bájáš
paajeeld	bájeelt
paajeeldceehis	bájeeldceehis
paajeeldhaŋgâ	bájeeldhaŋga
paajâ	bája
paaldâst	báldast
paalgâs	bálgas
paargâs	bárgas
paarooh	bárot
paarâ	bára
paasnik	básnik
paast	bást
paastaho	bástaho
paađur	báđur
paaŋŋâđ	báŋŋat
paccâhâš	bahccahaš
pacâdiđ	bacadit
paddâsiđ	baddasit
paddâđ	baddat
paggiđ	baggit
paha	baha
pahaduđ	bahadut
pahadâs	bahadas
pahakkâs	bahahkkas
pahalâš	bahalaš
pahheeđ	bahheet
pahudiđ	bahudit
pahâdistiđ	bahadistit
pahâdiđ	bahadit
pahčániđ	bakčánit
paifakkist	baifahkkist
paijeel	baijeel
paijeentoollâm	baijeentollan
paimâlâs	baibmalas
paimândiđ	baibmandit
paimâttiđ	baibmadtit
paimâđ	baibmat
paittuđ	baihttut
pajaldâs	bajaldas
pajalist	bajalist
pajalâš	bajalaš
pajanistiđ	bajanistit
pajaniđ	bajanit
paje	baji
pajedistiđ	bajedistit
pajediđ	bajedit
pajekielâ	bajekeala
pajemuš	bajemuš
pajeolmooš	bajeolbmoš
pajâččiđ	bajahččit
pakkeet	bahkkeet
pakkâ	bahkka
palaskiđ	balaskit
paldattâllâđ	baldahttallat
paldee	baldei
paldettiđ	baldehttit
paldeđ	baldet
paldâ	balda
paldâlistiđ	baldalistit
palgâđ	balgat
palijdiđ	balijdit
pallađ	ballat
palliđ	ballit
pallâhistiđ	ballahistit
palolâš	balolaš
palvâleijee	balvaleijei
palvâlem-	balvalem-
palvâliđ	balvalit
palvâlus	balvalus
palvâlusâst	balvalusast
palâkkistiđ	balagkistit
pamppâđ	bamppat
panjig	banjit
pannaal	badnál
panneeđ	badneet
panniđ	badnit
panttiittiđ	banttiihttit
panttâ	bantta
panâštiđ	banaitit
parahittiđ	barahihttit
pardeđ	bardet
pargeldiđ	bargeldit
pargo	bargo
pargokooskâst	bargokoskast
pargopiergâs	bargopeargas
pargopittá	bargopihttá
pargottem	bargohtten
parnâmčääci	barnamčáci
parnâđ	barnat
parttâšuđ	bartašut
parâkodde	baragoddi
parâlastâ	baralasta
parâpeeli	barabeeli
pase	basi
paseliđ	baselit
pasettiđ	basehttit
paskiittiđ	baskiihttit
paskooh	baskot
paskos	baskos
passaa	bassá
passaamus	bassámus
passeem	basseen
passeeđ	basseet
passuđ	bassut
pastel	bastel
pastem	basten
pastemnjune	bastemnjuni
pastettem	bastehtten
pastettuđ	bastehttut
pasteđ	bastet
patâreijee	batareijei
patârittiđ	batarihttit
patâriđ	batarit
pavestiđ	bavestit
pačarâs	bačaras
pačâlâhčâđ	bačalakčat
paččeeđ	bahččeet
paččođ	bahččot
paččuđ	bahččut
pađđeeđ	bađđeet
paŋâliđ	baŋalit
paškestuđ	baikestut
paštuuttiđ	baituhttit
pecičuskâ	becičuska
peeccih	beahccit
peeci	beaci
peeggâlm	beaggaln
peeicâ	beaica
peeilâ	beaila
peeivipaaštâ	beaivipáita
peeli	beali
peeliš	beališ
peeljis	bealjis
peeljâs	bealjas
peenuv	beanuv
peerbil	bearbil
peerrâđ	bearrat
peertis	beartis
peesi	beasi
peessiđ	beassit
peessâđ	beassat
peettâđ	beahttat
peggimsaahâ	beggimsáha
peggiđ	beggit
pegâlmâs	begalbmas
peht	beht
pehtil	behtil
pehtilistiđ	behtilistit
pehtilittiđ	behtilihttit
peittâdâttâđ	beihttadadtat
peittâttâđ	beihttadtat
peivi	beivi
peiviv	beiviv
pekkuđ	behkkut
pekkânjuš	behkkanjuš
pelbi	belbi
peldi	beldi
pele	beli
pelemat	belemat
peles	beles
pelgi	belgi
pelhittuđ	belhihttut
pelhittâttâđ	belhihttadtat
pelihaadan	belihádan
pelikyeimi	belikuoibmi
pelji	belji
peljikappeer	beljikahppeer
peljikässi	beljikássi
peljipel	beljipel
peljistäđđee	beljistáđđei
peljittem	beljihtten
peljiš	beljiš
pelkkiliđ	belkilit
pelkkiđ	belkit
pelnub	belnut
pennâgâš	bednagaš
penttâ	bentta
penuvkuálus	benuvkoalus
penuvráiđu	benuvráiđu
perbildiđ	berbildit
peri	beri
perriđ	berrit
perrâdâh	berradat
persovn	bersovn
perustiđ	berustit
peski	beski
peskidiđ	beskidit
peskâ	beska
peskâheivi	beskaheivi
peskâsävŋi	beskasávŋi
pessi	bessi
pessijááh	bessiját
pessijâš-	bessijaš-
pessiđ	bessit
pestittiđ	bestihttit
pestiđ	bestit
petittâttâđ	betihttadtat
pettee	behttei
pettiđ	behttit
pettuđ	behttut
pettâšuđ	behttašut
pevdi	bevdi
pevdilijne	bevdilijni
pevdiláá	bevdilá
pevdipijgá	bevdipijgá
pevviruššâđ	bevviruššat
peŋkkâ	beŋkka
peškiđ	beikit
pešnirihhááš	bešnirihháš
peštrihhááš	beštrihháš
piano	biano
pic	bic
piddojyelgi	biddojuolgi
pieggii	beaggii
pieggiittuđ	beaggiihttut
piegguutteijee	beagguhtteijei
pieggâ	beagga
pieggâspälli	beaggaspálli
pieijâđ	beaijat
pieijâđ joton	beaijađ joton
piellivâs	beallivas
pielâsčuárvi	bealasčoarvi
piemmee	beapmei
piemmâđ	beapmat
pierbildiđ	bearbildit
piergiittâllâđ	beargiihttallat
piergiđ	beargit
piernah	bearnat
pierni	bearni
piervâl	bearvval
piervâldiđ	bearvvaldit
pietittem	beatihtten
piettâliđ	beahttalit
pietâdid	beatadit
pievlii	beavlii
pievlâ	beavla
pievlâđ	beavlat
pieđgiđ	beađgit
piiccâđ	biihccat
piiru	biiru
piivdus	biivdus
piivnoh	biivdnot
piivtâs	biivtas
piiŋušpeeli	biiŋušpeeli
pijguđ	bijgut
pijgá	bijgá
pijnešuđ	bijnešut
pijpostâllâđ	bijpostallat
pijssáđ	bijssát
pikkánj	bihkkánj
piksâ	biksa
pile	bili
pilkke	bilki
pilkkediđ	bilkedit
pilkku	bilku
pille	billi
pilledeijee	billedeijei
pillediđ	billedit
pillâšum	billašon
pillâšuđ	billašut
piltto	bilto
pime	bimi
pintediđ	bintedit
piparkákku	biparkáhkku
pippârkákku	bihpparkáhkku
pircostiđ	bircostit
pirrâ	birra
pirrâdâh	birradat
pirrâjuurbâs	birrajurbas
pirrâluvâi	birraluvai
pirrâmpeivi	birrampeivi
pirrâčuoppâm	birračuohppan
pirrâčuoppâmvuotâ	birračuohppamvuohta
pirâldâs	biraldas
pismár	bismár
pismárâššâđ	bismáraššat
pisovâš	bisovaš
pissiđ	bissit
pisso	bisso
pissoo	bisso
pisániđ	bisánit
pitejâš	bitejaš
pitteeđ	bihtteet
pittá	bihttá
pittásukkâr	bihttásuhkkar
pittááš	bihttáš
pivdee	bivdei
pivdeđ	bivdet
pivdo	bivdo
pivduu	bivdu
pivdáskiđ	bivdáskit
pivnohvuotâ	bivdnohvuohta
pivvâl	bivval
piäggálm	beaggáln
piägus	beagus
piäguttemsaahâ	beaguhttemsáha
piäguttiđ	beaguhttit
piäittáástâllâđ	beaihttástallat
piäivádâh	beaivádat
piäiválâš	beaiválaš
piäiváš	beaiváš
piäju	beaju
piäldutubbáák	bealdutubbák
piälháttâllâđ	bealháhttallat
piälkkáđ	bealkát
piällást	beallást
piällâs	beallas
piäluštiđ	bealuitit
piälálâš	bealálaš
piämmu	beapmu
piärgu	beargu
piärgumääli	beargumáli
piärgumäälis	beargumális
piärán	bearán
piäsádâh	beasádat
piättárrääsi	beahttárrási
piättáá	beahttá
piättârrääsi	beahttarrási
piätu	beatu
piätuellee	beatuellei
piätulâš	beatulaš
piävtálmittiđ	beavtálbmihttit
piävuttiđ	beavuhttit
piäđgud	beađgut
piäđgui	beađgui
piäškáđ	beaikát
piđđeeđ	biđđeet
piškerdiđ	biikerdit
piškođ	biikot
piškádiđ	biikádit
pištee-	biitee-
pištel	biitel
pištem	biiten
pištevâš	biitevaš
pišteđ	biitet
plaakaat	blákát
poggâ	bogga
poggâgiđ	boggagit
poggâđ	boggat
pogâstiđ	bogastit
pogâštuđ	bogaitut
pohe	bohi
pohheel	bohheel
pohteđ	bohtet
pokke	bohkki
pokkečuárvi	bohkkečoarvi
pokkiđ	bohkkit
pokkođ	bohkkot
pokkáá	bohkká
pokkâšuđ	bohkkašut
polgâm	bolgan
pollo	bollo
polster	bolster
polsâ	bolsa
polttijâš	boltijaš
polttođ	boltot
polvii	bolvii
polviđ	bolvit
polvâ	bolva
polvâšoŋŋâ	bolvašoŋŋa
polâttettee	boladtehttei
pompestiđ	bompestit
ponccár	bonccár
poneh	bonet
ponjeldiđ	bonjeldit
ponne	bodni
ponnjood	bonnjot
ponnjáá	bonnjá
ponos	bonos
poogâs	bogas
pooliš	boliš
poonjeeld	bonjeelt
pooráđ	borát
poorâ	bora
poossâđ	bossat
poovčâs	bovčas
poođâš	bođaš
porfiđ	borfit
porfâgiđ	borfagit
porgemáánu	borgemánu
porgesoksâmijguim	borgesoksamijguin
porgiš	borgiš
porgottiđ	borgohttit
porgádiđ	borgádit
porgâttiđ	borgadtit
porgâđ	borgat
poros	boros
porottuđ	borohttut
porree	borrei
porrânjâs	borranjas
porskâšuđ	borskašut
porthááh	borthát
portháš	bortháš
poršše	boršši
posijpeivi	bosijpeivi
poskâd	boskat
poskâdiđ	boskadit
poskâniđ	boskanit
posoliđ	bosolit
posoluđ	bosolut
posolâhčâđ	bosolakčat
possoođ	bossot
poster	boster
postinjâš	bostinjaš
postânjuš	bostanjuš
posádiđ	bosádit
posâdâttâđ	bosadadtat
posâlid	bosalit
posâlâddâđ	bosaladdat
posâlâhčâđ	bosalakčat
potkâ	botga
potkâniđ	botganit
potkânâddâđ	botganaddat
pottuđ	bohttut
pottáák	bohtták
pottáás	bohttás
pottâ	bohtta
potás	botás
potâliđ	botalit
povdiittâs	bovdiihttas
povdim	bovdin
povnâ	bovdna
povustem	bovusten
povustiđ	bovustit
povvâdiđ	bovvadit
povvâdâs	bovvadas
povvâstem	bovvasten
povvâstiđ	bovvastit
povvâstâllâđ	bovvastallat
povčâgiđ	bovčagit
povčâstiđ	bovčastit
pozettiđ	bozehttit
pozzelâttâđ	bozzeladtat
pozzásiđ	bozzásit
pozáttâllâđ	bozáhttallat
počâšiđ	bočašit
poččâ	bohčča
pođgeđ	bođget
pođoi	bođoi
pođâččiđ	bođahččit
poŋkkeđ	boŋkket
poškâ	boika
poškâttuđ	boikadtut
priivaat	briivát
prinsiip	brinsiit
pugârdiđ	bugardit
puhelin	buhelin
puhhiittâh	buhhiihttat
puhhiđ	buhhit
puhkâliđ	buhgalit
puicce	buihcci
puigâ	buiga
puijáđ	buiját
puitteđ	buihttet
puksâ-	buksa-
puksâluágih	buksaloagit
puldo	buldo
puljárâh	buljárat
puljârittiđ	buljarihttit
pullá	bullá
pullárittiđ	bullárihttit
pulláruh	bullárut
pulske	bulski
pulttâsiđ	bultasit
pumppu	bumppu
pumppâ	bumppa
punccâruššâđ	bunccaruššat
punjâdâttâđ	bunjadadtat
punjâgiđ	bunjagit
punjâlâttâđ	bunjaladtat
punjâsiđ	bunjasit
punjâttâllâđ	bunjadtallat
punnjuđ	bunnjut
puocâlâs	buocalas
puocâmuš	buocamuš
puoh	buot
puohah	buohat
puohlágán	buohlágán
puohrekkân	buohrehkkan
puohânissii	buohanissii
puohčâliđ	buokčalit
puohčâđ	buokčat
puoidâ	buoida
puolvâ	buolva
puolâččiđ	buolahččit
puolâš	buolaš
puolâšluoddiittâh	buolašluoddiihttat
puoriš	buoriš
puoskâ	buoska
puoskâsekkâ	buoskasehkka
puosâh	buosat
puovnjâgiđ	buovnjagit
puovtâ	buovta
puovtâdiđ	buovtadit
puoŋâ	buoŋa
purccáđ	burccát
purdo	burdo
purgiistiđ	burgiistit
purguđ	burgut
purgániđ	burgánit
purgâ	burga
purgâđ	burgat
purjániđ	burjánit
purjâstiđ	burjastit
purruđ	burrut
purrâmušlasâttâh	burramušlasadtat
purrâmâš	burramaš
purrâđ	burrat
purssâ	burssa
purâdiđ	buradit
purâdâttâđ	buradadtat
purâhinnáá	burahidná
purâstuđ	burastut
purâtteijee	buradteijei
purâttiđ	buradtit
pusnjâš	busnjaš
pussuđ	bussut
pussáá	bussá
putestiđ	butestit
puttâdiđ	buhttadit
puttâl	buhttal
puttâlâš	buhttalaš
puttâmäigi	buhttamáigi
puttâniđ	buhttanit
puttâđ	buhttat
putásmiđ	butásmit
puuhâđ	buhat
puuljâr	buljar
puunnjâđ	bunnjat
puunâm	bunan
puurgâs	burgas
puurist	burist
puurrâmhaalu	burramhálu
puurrâmlusto	burramlusto
puurrâmmielâ	burrapmeala
puurâs	buras
puustav	bustav
puustuv	bustuv
puutijâš	butijaš
puuvsah	buvsat
puuŋkâs	buŋkas
puvdâ	buvda
puzzâloovdâ	buzzalovda
puzzânjuolâ	buzzanjuola
puzzâsolge	buzzasolgi
puácuvuotâ	boacuvuohta
puáhtámuš	boahtámuš
puáhuduđ	boahudut
puáhuttiđ	boahuhttit
puáhánjistiđ	boahánjistit
puáhčániđ	boakčánit
puáidudekes	boaidudekes
puáidudeves	boaidudeves
puáiduđ	boaidut
puáidáh	boaidát
puáidášiđ	boaidášit
puáimuđ	boaibmut
puáissijdâ	boaissijda
puájui	boajui
puájuiduđ	boajuidut
puákkudiđ	boahkkudit
puáksuđ	boaksut
puákuttiđ	boakuhttit
puáldimaamnâs	boaldimámnas
puáldimmuorâ	boaldipmuora
puáldiđ	boaldit
puáldámuš	boaldámuš
puáldáttâh	boaldáhttat
puálli	boalli
puállu	boallu
puállunjune	boallunjuni
puállurääsi	boallurási
puállááttiđ	boalláhttit
puállááttâs	boalláhttas
puálláđ	boallát
puálooh	boalot
puánjostiđ	boanjostit
puánjumâš	boanjumaš
puánjus	boanjus
puánnjuđ	boannjut
puáris	boaris
puáriskállárääsi	boariskállárási
puárkkáá	boarká
puárree	boarrei
puársku	boarsku
puárskudiđ	boarskudit
puárvár	boarvvár
puárániđ	boaránit
puáránâddâđ	boaránaddat
puáráttâs	boaráhttas
puáskudiđ	boaskudit
puáskulâs	boaskulas
puáskustâllâđ	boaskustallat
puáskuđ	boaskut
puástu	boastu
puástuvuotâ	boastuvuohta
puásuh	boasut
puásui	boasui
puásui-iäigád	boasui-eaigát
puásuialmai	boasuialbmai
puásuikeččee	boasuikehččei
puásuiluđ	boasuilut
puásuiolmooš	boasuiolbmoš
puásuiomâsteijee	boasuiomasteijei
puásuiriges	boasuiriges
puásuisijdâ	boasuisijda
puásuittuđ	boasuihttut
puátilistiđ	boatilistit
puátiliđ	boatilit
puátkuduđ	boatgudut
puátlistiđ	boatlistit
puáttee	boahttei
puátteš	boahtteš
puáttiđ	boahttit
puázzi	boazzi
puáđhudiđ	boađhudit
puáđistiđ	boađistit
puáššáá	boaššá
puđâldâs	buđaldas
puŋkki	buŋkki
puŋkkáđ	buŋkkát
puško	buiko
puškosáággáš	buikosággáš
puškáristiđ	buikáristit
pušteđ	buitet
pyeccee	buohccei
pyecceiauto	buohcceiauto
pyehtiđ	buohtit
pyeidi	buoidi
pyeidittem	buoidihtten
pyeidivepsi	buoidiveksi
pyelestiđ	buolestit
pyelliđ	buollit
pyeredistiđ	buoredistit
pyerediđ	buoredit
pyeredâttâđ	buoredadtat
pyereest	buoreest
pyereestpuáttim	buoreestpoahttin
pyeri	buori
pyeripuáttim	buoripoahttin
pyeritátulâš	buoritátulaš
pyerá	buorá
pyevtittiđ	buovtihttit
pyevtittâs	buovtihttas
pyeŋes	buoŋes
pyhámestpeivi	byhámestpeivi
páguttiđ	báguhttit
págárnjistiđ	bágárnjistit
páhudistiđ	báhudistit
páhudiđ	báhudit
páiháttuvâi	báiháhttuvai
páinu	báinu
pájálistiđ	bájálistit
pákkum	báhkkon
pákkuđ	báhkkut
pálhustiđ	bálhustit
pálhášume	bálhášumi
pállurääsi	bállurási
páláttistiđ	báláhttistit
pánnu	bádnu
pánttááttiđ	bánttáhttit
pánttáđ	bánttát
pánáidittiđ	bánáidihttit
pánálistiđ	bánálistit
párccáđ	bárccát
párguttiđ	bárguhttit
párguđ	bárgut
párgádiđ	bárgádit
párkku	bárku
párnáá	bárná
párttu	bártu
párttuluđ	bártulut
pártáskiđ	bártáskit
párudiđ	bárudit
párudâllâđ	bárudallat
párustiđ	bárustit
páránâššâđ	báránaššat
párásist	bárásist
pássár	bássár
pávkkuđ	bávkkut
pááhu	báhu
pááihui	báihui
pááikán	báikán
páájáseh	bájáset
pááppár	báhppár
páárnáš	bárnáš
pááru	báru
pážžuđ	bážžut
päccee	báhccei
päddi	báddi
päddikeš-	báddikeš-
pähti	báhti
päikki	báihkki
päikkiellee	báihkkeallei
päikkikodde	báihkkikoddi
päikkipargo	báihkkipargo
päinittiđ	báinihttit
päiniđ	báinit
päiđi	báiđi
päiđittuđ	báiđihttut
päjidiđ	bájidit
päjistiđ	bájistit
päjittittiđ	bájihttihttit
päjittâttâđ	bájihttadtat
päksiđ	báksit
päldee	báldei
päljis	báljis
päljispoođâi	báljispođai
pälkki	bálki
pänijieŋâ	bánijeaŋa
päniruuggâin	bániruggain
pänittem	bánihtten
pänittuđ	bánihttut
päniuážži	bánioažži
pärdiđ	bárdit
pärni	bárni
pärtti	bárti
pärttidiđ	bártidit
päskid	báskit
pävkkiđ	bávkkit
pääccid	báhccit
pääcciđ	báhccit
pääcis	bácis
pääihist	báihist
päälgis	bálgis
pääli	báli
pääljis	báljis
pääni	báni
pääsi	bási
pääti	báti
päävir	bávir
päävtipajalâs	bávtipajalas
pääččim	báhččin
pääččimviärju	báhččimvearju
pääččiđ	báhččit
pääđđiđ	báđđit
päštil	báitil
päštiđ	báitit
pövkkyr	bövkkyr
raahiđ	ráhit
raaijâđ	ráijat
raameeg	rámeet
raami	rámi
raamâ	ráma
raapoort	ráport
raattâđ	ráhttat
raavâ	ráva
raavâdviäsu	rávadveasu
raddalâs	raddalas
raddalâstáálu	raddalastálu
radde	raddi
raddelijne	raddelijni
raddii	raddii
raddâ	radda
rahhiđ	rahhit
rahttâttâđ	rahttadtat
rahtuđ	rahtut
rahtâččiđ	rahtahččit
raigiđ	raigit
raigâđ	raigat
raijiđ	raijit
raiđuustiđ	raiđustit
raiđuustâllâđ	raiđustallat
rakânâs	rakanas
rame	rami
rammuđ	rapmut
ramsahkuđ	ramsahgut
ramâdâs	ramadas
ramâččâttâđ	ramahččadtat
ranjestiđ	ranjestit
ranttu	ranttu
rappâ	rahppa
rasijâš	rasijaš
rasta	rasta
rastasiisâ	rastasiisa
ratkuuttâh	ratguhttat
ratkuđ	ratgut
ravintola	ravintola
ravkkâđ	ravkkat
ravviittâs	ravviihttas
ravvim	ravvin
ravvimpalvâlus	ravvimpalvalus
ravviđ	ravvit
ravŋâstiđ	ravŋastit
ravžâ	ravža
raččođ	rahččot
rađe	rađi
rađđim	rađđin
rađđiđ	rađđit
raše	raši
raššoođ	raššot
reekkig	reahkkit
reettiđ	reahttit
reettâđ	reahttat
reevâs	reavas
registeeriđ	registeerit
registeristiđ	registeristit
rehelâš	rehelaš
reikkiđ	reihkkit
reissiđ	reissit
reivâ	reiva
rekinistiđ	rekinistit
reknistiđ	reknistit
renttiđ	renttit
renttâ	rentta
repči	repči
restiđ	restit
restâluđ	restalut
retkiđ	retgit
rettâ	rehtta
revkkee	revkkei
revni	revdni
revnigâsân	revdnigasan
revnigâsâst	revdnigasast
reŋguustiđ	reŋgustit
reŋguđ	reŋgut
reŋgâ	reŋga
reškiđ	reikit
rešmi	rešmi
reštiđ	reitit
ribjâ	ribja
riddo	riddo
riddokuávlu	riddokoavlu
riddoláá	riddolá
riddoniđ	riddonit
riddoviemmâr	riddoveapmar
rieggee	reaggei
riegis	reagis
riehti	reahti
riehtiđ	reahtit
riehtâ	reahta
riehâ	reaha
rievdâdiđ	reavdadit
rievtis	reavtis
rievtistiđ	reavtistit
rievtâgergi	reavtagergi
rieštiđ	reaitit
riges	riges
rigesvuotâ	rigesvuohta
riggee	riggei
riggodâh	riggodat
riggodâttâđ	riggodadtat
riggođ	riggot
rigášiđ	rigášit
riijkâ	riijka
riijkâvuálásâš	riijkavoalásaš
riijkâvuálásâšvuotâ	riijkavoalásašvuohta
riimmân	riipman
riičâs	riičas
riišâ	riiša
rijdeđ	rijdet
rijdo	rijdo
rijduu	rijdu
rijdáskiđ	rijdáskit
rijdâliđ	rijdalit
rijgá	rijgá
rijjâ	rijja
rijjâtátulâš	rijjadátulaš
rijjâvuotâ	rijjavuohta
rijjâäigi	rijjaáigi
rijttáđ	rijttát
rijváđ	rijvát
rikkođ	rihkkot
rilláđ	rillát
rimnje	rimnji
rimnjo	rimnjo
rimnjođ	rimnjot
rimnjâliđ	rimnjalit
rimččáđ	rimččát
rimččâliđ	rimččalit
rimške	rimški
rimškođ	rimškot
rippo	rihppo
rippokuáti	rihppokoati
rippásiđ	rihppásit
rippâ	rihppa
ripsottiđ	riksohttit
ripáttiđ	ripáhttit
ripâstiđ	ripastit
ripšâttâllâđ	ripšadtallat
risthâs	risthas
ristâ	rista
ristâlâsân	ristalasan
ristâlâš	ristalaš
rivgoo	rivgo
riähtániđ	reahtánit
riäiháđ	reaihát
riänduđ	reandut
riännáđ	readnát
riänttu	reanttu
riänttáđ	reanttát
riäpu	reapu
riäská	reaská
riätká	reatgá
riävdu	reavdu
riävnu	reavdnu
riävská	reavská
riävskávälli	reavskáválli
riävtui	reavtui
riäváttâllâđ	reaváhttallat
riäŋkku	reaŋkku
ričče	rihčči
riččáđ	rihččát
riđo	riđo
riššo	riššo
riššâ	rišša
riššâsäggi	riššasággi
robdâ	robda
robdâhuámášuttem	robdahoamášuhtten
rogge	roggi
rohhoođ	rohhot
rohhááttiđ	rohháhttit
rohâdâs	rohadas
rohâstiđ	rohastit
rokke	rohkki
rokkeluđ	rohkkelut
rokkâđ	rohkkat
rome	romi
ronediđ	ronedit
ronedâttâđ	ronedadtat
ronno	rodno
ronnodâh	rodnodat
rooccâd	rohccat
roohâđ	rohat
roonnig	rodnit
roossâđ	rossat
roottâđ	rohttat
roppe	rohppi
roppâ	rohppa
roppâđ	rohppat
roske	roski
roskekoori	roskekori
roskelitte	roskelihtti
roskiđ	roskit
rossâ	rossa
rotoi	rotoi
rottâsiđ	rohttasit
rovvi	rovvi
rovvâđ	rovvat
rubbođ	rubbot
ruddođ	ruddot
ruggâđ	ruggat
ruhnođ	ruhnot
ruhâdâs	ruhadas
ruigo	ruigo
rukkoos	ruhkkos
rummâš	rupmaš
rummâšuási	rupmašoasi
rumppiđ	rumppit
rumâduđ	rumadut
rumâšlâš	rumašlaš
rundođ	rundot
ruohâstiđ	ruohastit
ruoinâs	ruoinas
ruoinâđ	ruoinat
ruoinâšiđ	ruoinašit
ruojijdiđ	ruojijdit
ruojâ	ruoja
ruojâstiđ	ruojastit
ruokkâd	ruohkkat
ruokâsmiđ	ruokasmit
ruollâ	ruolla
ruomčâstiđ	ruomčastit
ruonâs	ruonas
ruopsisvuásáš	ruoksisvoasáš
ruossâ	ruossa
ruossâhâš	ruossahaš
ruossâlâs	ruossalas
ruossâlâsân	ruossalasan
ruostâ	ruosta
ruosâdiđ	ruosadit
ruosâttiđ	ruosadtit
ruottiđ	ruohttit
ruottâpeivi	ruohttabeivi
ruottâđ	ruohttat
ruotâdiđ	ruotadit
ruotâkielâ	ruotageala
ruotâs	ruotas
ruotâsmuđ	ruotasmut
ruotâstittiđ	ruotastihttit
ruotâstiđ	ruotastit
ruotâstuđ	ruotastut
ruotâttiđ	ruotadtit
ruoččâđ	ruohččat
ruođâ	ruođa
ruoŋâ	ruoŋa
ruoškâđ	ruoikat
ruošâkielâ	ruošageala
ruošâs	ruošas
ruoššâ	ruošša
russoođ	russot
rustâ	rusta
ruttâ	ruhtta
ruttâdiđ	ruhttadit
ruttâluđ	ruhttalut
ruttâtuálu	ruhttadoalu
ruuki	ruki
ruumâš	rumaš
ruutiin	rutiin
ruuvtâmitto	ruvtamihtto
ruvgâliđ	ruvgalit
ruvviđ	ruvvit
ruzze	ruzzi
ruábbáá	roabbá
ruáhu	roahu
ruáhuttiđ	roahuhttit
ruáhásistiđ	roahásistit
ruáhásiđ	roahásit
ruáhásâddâđ	roahásaddat
ruáibuđ	roaibut
ruáibáđ	roaibát
ruáinudiđ	roainudit
ruáinudâttâđ	roainudadtat
ruáinuđ	roainut
ruáiru	roairu
ruáiskuliđ	roaiskulit
ruáiskuđ	roaiskut
ruákki	roahkki
ruákášâttâđ	roakášadtat
ruámmuđ	roapmut
ruámnjádâhpieggâ	roamnjádahbeagga
ruámčči	roamčči
ruámččááttiđ	roamččáhttit
ruánjis	roanjis
ruánnu	roadnu
ruánnuđ	roadnut
ruántti	roantti
ruánuáldu	roanoaldu
ruánučuáđgi	roanučoađgi
ruánáá	roaná
ruánááeennâmlâš	roanáeednamlaš
ruáppániđ	roahppánit
ruástil	roastil
ruástudiđ	roastudit
ruástumettum	roastumehtton
ruástuđ	roastut
ruáttuđ	roahttut
ruáttáá	roahttá
ruátuluđ	roatulut
ruávdádittiđ	roavdádihttit
ruávdáduttiđ	roavdáduhttit
ruávis	roavis
ruávkku	roavkku
ruávru	roavru
ruávádâh	roavádat
ruávŋi	roavŋi
ruáŋguđ	roaŋgut
ruáŋgáđ	roaŋgát
ruáŋis	roaŋis
ruáŋkki	roaŋkki
ruášku	roaiku
ruáškuđ	roaikut
ruđâttuđ	ruđadtut
ruŋgo	ruŋgo
ruŋŋiittâllâđ	ruŋŋiihttallat
ruškodiđ	ruikodit
ruškáđ	ruikát
ruškâd	ruikat
rušmosmittiđ	rušmosmihttit
ružžáđ	ružžát
ryeksi	ruoksi
ryemčči	ruomčči
ryetti	ruohtti
ryevdi	ruovdi
ryevdipállu	ruovdipállu
ryeššilâš	ruoššilaš
rábbuđ	rábbut
rágguđ	rággut
ráhtiđ	ráhtit
ráhtulâšvuotâ	ráhtulašvuohta
ráhtádâs	ráhtádas
ráhtádâttâđ	ráhtádadtat
ráhtálâšvuotâ	ráhtálašvuohta
ráigáá	ráigá
ráilu	ráilu
ráivuđ	ráivut
ráiđu	ráiđu
ráiđukove	ráiđukovi
ráiđutáálu	ráiđutálu
rámmá	rápmá
rámškuđ	rámškut
ránnjá	ránnjá
ránudiđ	ránudit
ránásmiđ	ránásmit
ráptu	ráktu
rásáduđ	rásádut
rátká	rátgá
rávhudiđ	rávhudit
rávhuttem	rávhuhtten
rávhuttuttiđ	rávhuhttuhttit
rávhuttuđ	rávhuhttut
rávhálâš	rávhálaš
ráváttâllâđ	ráváhttallat
rááju	ráju
rááján	ráján
ráánu	ránu
ráássuđ	rássut
ráátu	rátu
ráávhu	rávhu
ráávuh	rávut
ráđádâh	ráđádat
ráđádâllâm	ráđádallan
ráđádâllâđ	ráđádallat
rášuarve	rášuarvi
râkkân	ragkan
räbbi	rábbi
rähtee	ráhtei
rähtittiđ	ráhtihttit
rähtiđ	ráhtit
räi	rái
räigi	ráigi
räigidiđ	ráigidit
räijejeijee	ráijejeijei
räiđee	ráiđei
räiđi	ráiđi
rämidiđ	rámidit
ränisnuárju	ránisnoarju
ränisoppuu	ránisohppu
rännee	rádnei
rätkiđ	rátgit
rävisolmooš	rávisolbmoš
rävkki	rávkki
rävŋi	rávŋi
räägis	rágis
rääjist	rájist
räämi	rámi
räänis	ránis
rääsi	rási
räättiđ	ráhttit
rääđi	ráđi
räđidiđ	ráđidit
räđđejeijee	ráđđejeijei
saahâ	sáha
saahâd	sáhat
saaibâs	sáibas
saajeest	sájeest
saallâđ	sállat
saalâs	sálas
saanah	sánat
saanjâ	sánja
saargâ	sárga
saargâs	sárgas
saarrâđ	sárrat
saasâ	sása
saaveeh	sáveet
saaveehnjune	sáveehnjuni
saaveehpäddi	sáveehbáddi
saaveehvárvu	sáveehvárvu
saavzah	sávzat
saavâ	sáva
saaččâđ	sáhččat
saađđâđ	sáđđat
saaŋaaš	sáŋáš
saddađ	saddat
saddeđ	saddet
saggiđ	saggit
sagâstiđ	sagastit
sahe	sahi
saheliđ	sahelit
sahhii	sahhii
sahhiittâllâđ	sahhiihttallat
saijaa	saijá
saijeem	saijeen
saimâ	saibma
saivâ	saiva
saivâčääci	saivačáci
sajadâh	sajadat
sajan	sajan
sajanmáksu	sajanmáksu
sajasis	sajasis
sajattâh	sajahttat
saje	saji
sajessuonâ	sajessuona
sajestis	sajestis
sajettem	sajehtten
sajettuđ	sajehttut
sakkoáldu	sahkkoáldu
salbâstiđ	salbastit
salgii	salgii
salgâ	salga
salkkađ	salkat
salkkiđ	salkit
salkkâniđ	salkanit
salliđ	sallit
salloođ	sallot
salttiistiđ	saltiistit
salttiđ	saltit
sannjii	sannjii
sappadistiđ	sahppadistit
sappadiđ	sahppadit
sappeed	sahppeet
sapâristiđ	saparistit
sapârâs	saparas
sarapäddi	sarapáddi
sare	sari
sarettuđ	sarehttut
sargâstiđ	sargastit
sargâđ	sargat
sarves	sarvves
sarâläbži	saralábži
sattuđ	sahttut
satâččiđ	satahččit
savadittiđ	savadihttit
savadâh	savadat
savestiđ	savestit
savjâ	savja
savjâčääci	savjačáci
savjâđ	savjat
savo	savo
savosuonâ	savosuona
savveeđ	savveet
savzâ	savza
savzâduh	savzadut
savâstiđ	savastit
savâstâllâđ	savastallat
savŋeliđ	savŋelit
sačâliđ	sačalit
sađhme	sađhmi
saŋestavdâ	saŋestavda
saŋkko	saŋkko
seegis	seagis
seehi	seahi
seeibuš	seaibuš
seeljah	sealjat
seellâđ	seallat
seervij	searvvij
seettiđ	seahttit
seevi	seavi
seevtil	seavtil
seeččâl	seahččal
seeŋâs	seaŋas
seggi	seggi
segidiđ	segidit
sehhiđ	sehhit
seivâgist	seivagist
sekkâ	sehkka
seles	seles
selgi	selgi
selgiruođâ	selgiruođa
selgisuonâ	selgisuona
selgâniđ	selganit
selgâttiđ	selgadtit
selvâttiđ	selvadtit
selâttiđ	seladtit
selâttâs	seladtas
semmuđ	sepmut
septinjune	sektinjuni
servi	servi
servidiđ	servvidit
servikodde	servvikoddi
servikoddepargee	servvikoddepargei
servâđ	servvat
setitoho	setitoho
sevetäävtih	sevetávtit
sevŋâd	sevŋat
sevŋâniđ	sevŋanit
sečâlâs	sečalas
seđŋiittâttâđ	seđŋiihttadtat
seđŋiđ	seđŋit
seŋes	seŋes
seŋgâloovdâ	seŋgalovda
sibžádâh	sibžádat
siebliđ	seablit
sieivâ	seaiva
sieiŋânjune	seaiŋanjuni
siejâ	seaja
siemin	seamin
siemâ	seama
sieptiđ	seaktit
sierriđ	searrit
sierrâđ	searrat
sierâ	seara
sierâdiđ	searadit
sierânistiđ	searanistit
sierânâs	searanas
siessâl	seassal
sieđgâ	seađga
sieđgâluđ	seađgalut
signaal	signál
sihodâttâđ	sihodadtat
siholdâh	siholdat
siholdâs	siholdas
sihostiđ	sihostit
sihtâ	sihta
siigur	siigur
siijvost	siijvost
siikuur-	siikur-
siillâđ	siillat
siimpâl	siimpal
siisâ	siisa
siittâđ	siihttat
siivvâd	siivvat
sij	sij
sijdâ	sijda
sijdâkyeimi	sijdaguoibmi
sijgâ	sijga
sijgâdiđ	sijgadit
sijmá	sijmá
sijvo	sijvo
sijvuht	sijvuht
sikkođ	sihkkot
silbâ	silba
silde	sildi
sile	sili
sillee	sillei
silloođ	sillot
silluđ	sillut
silppođ	silpot
sino	sino
sinoluđ	sinolut
sirdeđ	sirdet
sirottâsah	sirohttasat
siskediđ	siskedit
siskiš	siskiš
siste	sisti
sistees	sistees
sistáád	sistát
sistáán	sistán
site	siti
sittá	sihttá
siveldiđ	siveldit
sivlo	sivlo
sivnediđ	sivdnedit
sivnáđ	sivdnát
sivo	sivo
sivâstiđ	sivastit
siäbládâh	seabládat
siähuđ	seahut
siähálâsmuáti	seahálasmoati
siäijuđ	seaijut
siäiludiđ	seailudit
siäiluttiđ	seailuhttit
siäivuđ	seaivut
siäkku	seahkku
siälulâš	sealulaš
siäládâh	sealádat
siämmást	seapmást
siämmáá	seapmá
siämmáánáál	seapmánál
siämmáš	seapmáš
siärgádiđ	seargádit
siäsá	seasá
siävuttiđ	seavuhttit
siävuttâs	seavuhttas
siävvuđ	seavvut
siävŋus	seavŋus
siävŋál	seavŋál
siävŋánittiđ	seavŋánihttit
siävŋánuđ	seavŋánut
siävŋášiđ	seavŋášit
siäđus	seađus
siäđđuđ	seađđut
siđâruđ	siđarut
siŋnaal	siŋnál
skaallân	skállan
skaappuđ	skáhpput
skaađiđ	skáđit
skainiđ	skainit
skainâšuđ	skainašut
skalijdiđ	skalijdit
skalmiđ	skalbmit
skalvâđ	skalvat
skappuđ	skahpput
skarbâđ	skarbat
skarppaa	skarpá
skarppađ	skarpat
skarttiđ	skartit
skavadiđ	skavadit
skačâlistiđ	skačalistit
skačâlittiđ	skačalihttit
skaŋkkâđ	skaŋkkat
skeikkiđ	skeihkkit
skelmušiđ	skelbmušit
skelmâ	skelbma
skemmiđ	skepmit
skerčijdiđ	skerčijdit
skerčádittiđ	skerčádihttit
skerčâgittiđ	skerčagihttit
skerčâgiđ	skerčagit
skeŋkkâ	skeŋkka
skiilhâs	skiilhas
skiillân	skiillan
skiiltâr	skiiltar
skiippâđ	skiihppat
skiivâs	skiivas
skiiđáár	skiiđár
skikkâ	skihkka
skikâlâš	skikalaš
skilettiđ	skilehttit
skilijdiđ	skilijdit
skilkkeđ	skilket
skilkkáđ	skilkát
skinne	skidni
skinnemuáddá	skidnemoaddá
skippii	skihppii
skippáár	skihppár
skipárâš	skipáraš
skirnádiđ	skirnádit
skirviittiđ	skirviihttit
skirviittâllâđ	skirviihttallat
skirvâniđ	skirvvanit
skirvânâddâđ	skirvvanaddat
skirčče-	skirčče-
skitârdiđ	skitardit
skivŋe	skivŋi
skiämmáđ	skeapmát
skiärru	skearru
skiärruđ	skearrut
skičijdiđ	skičijdit
skiđârdiđ	skiđardit
skižestiđ	skižestit
skolijdiđ	skolijdit
skolkkâliđ	skolkalit
skolmo	skolbmo
skoollân	skollan
skoorrân	skorran
skoođâs	skođas
skooŋkâs	skoŋkas
skovorâššâđ	skovoraššat
skovos	skovos
skovviđ	skovvit
skođeruššâđ	skođeruššat
skođmođ	skođmot
skuibâ	skuiba
skuiperdiđ	skuiperdit
skuirepuásui	skuirepoasui
skuirâgiđ	skuiragit
skulliđ	skullit
skulčottiđ	skulčohttit
skulččeđ	skulččet
skummiđ	skupmit
skuottâ	skuohtta
skuppiđ	skuhppit
skurnáttiđ	skurnáhttit
skurčâgiđ	skurčagit
skurččuu	skurčču
skurččáá	skurččá
skuuiper	skuiper
skuvgááttiđ	skuvgáhttit
skuvgâliđ	skuvgalit
skuvriđ	skuvrit
skuáibááttiđ	skoaibáhttit
skuálkkiđ	skoalkit
skuálkkáđ	skoalkát
skuálkuttiđ	skoalkuhttit
skuánnáá	skoadná
skuánnáđ	skoadnát
skuáppu	skoahppu
skuápálittiđ	skoapálihttit
skuárádâh	skoarádat
skuárččuđ	skoarččut
skuáttu	skoahttu
skuávhádiđ	skoavhádit
skuávkkiđ	skoavkkit
skuávkkááttiđ	skoavkkáhttit
skuáččur	skoahččur
skuážurdiđ	skoažurdit
skučeluđ	skučelut
skučálistiđ	skučálistit
skučâgiđ	skučagit
skuččáđ	skuhččát
skuđálgiđ	skuđálgit
skužestiđ	skužestit
skyelfi	skuolfi
skyennidiđ	skuodnidit
skájuttâttâđ	skájuhttadtat
skálžu	skálžu
skááđá	skáđá
skážžár	skážžár
skälvi	skálvi
skärtti	skárti
skäävi	skávi
smaavâs	smávas
smakkiđ	smahkkit
smakkâ	smahkka
smiergâliđ	smeargalit
smiettâđ	smeahttat
smietâstid	smeatastit
smiärgááttiđ	smeargáhttit
smiärruđ	smearrut
smiäru	smearu
smolkkiđ	smolkit
smákku	smáhkku
smätti	smáhtti
snavgis	snavgis
snavgâd	snavgat
snelkkiđ	snelkit
snielah	snealat
snielâhistiđ	snealahistit
snikkár	snihkkár
snjirgođ	snjirgot
snjirriittiđ	snjirriihttit
snorâniđ	snoranit
snuibe	snuibi
snuollâđ	snuollat
snuálttuđ	snoaltut
snuđgeđ	snuđget
snuđgođ	snuđgot
snáittu	snáihttu
snäldee	snáldei
snärkkiluđ	snárkilut
sogge	soggi
soggiđ	soggit
sogâdiđ	sogadit
sohteđ	sohtet
sohtâđ	sohtat
sohâluđ	sohalut
soiccâliđ	soihccalit
soicettiđ	soicehttit
soijiđ	soijit
soinâđ	soinat
sojopoccee	sojopohccei
soksii	soksii
soksâmijguim	soksamijguin
solge	solgi
sollâ	solla
sollâdiđ	solladit
solâstiđ	solastit
somijdiđ	somijdit
sondiđ	sondit
sonnjoođ	sonnjot
sonnâ	sodna
sooda	soda
soogâs	sogas
soohâđ	sohat
sooijiđ	soijit
soollâđ	sollat
soommân	sopman
sooppâđ	sohppat
soosi	sosi
soovsâ	sovsa
soovsâkaamuv	sovsagámuv
soovsâluđ	sovsalut
soovsâčalme	sovsačalbmi
soovđâs	sovđas
soođâ	sođa
sooŋâš	soŋaš
sopâmettum	sopamehtton
sopâmuš	sopamuš
sopâvâš	sopavaš
sorduđ	sordut
sore	sori
sorjođ	sorjot
soro	soro
sorolâš	sorolaš
sorttâ	sorta
sorttâdiđ	sortadit
sorváđ	sorvvát
sorččáđ	sorččát
sote	soti
sotkâđ	sotgat
sotkâšuđ	sotgašut
sottáán	sohttán
soves	soves
sovestiđ	sovestit
sovkkâliđ	sovkkalit
sovle	sovli
sovláá	sovlá
sovskaamuv	sovskámuv
sovâdâttâđ	sovadadtat
sovâttiđ	sovadtit
sovâttâllâđ	sovadtallat
sovđâ	sovđa
sovđâđ	sovđat
soŋottiđ	soŋohttit
spaanjâ	spánja
spaassip	spássit
spaihâstiđ	spaihastit
sparhâttâs	sparhadtas
sparrodiđ	sparrodit
spelliđ	spellit
spiddáádâttâđ	spiddádadtat
spiekki	speahkki
spiekâstiđ	speakastit
spiijkár	spiijkár
spiiđđâđ	spiiđđat
spijne	spijni
spirppáá	spirpá
spiäkkuđ	speahkkut
spiđgeđ	spiđget
spižá	spižá
spižže	spižži
spižžiđ	spižžit
spolččâđ	spolččat
spoorrân	sporran
spooviđ	spovit
sporijdem	sporijden
sporijdiđ	sporijdit
sporriđ	sporrit
spálččá	spálččá
spááđá	spáđá
späigiđ	spáigit
späilihât	spáilihat
spälli	spálli
spääilih	spáilit
spääjeeh	spájeet
sraŋgâ	sraŋga
srevžâđ	srevžat
srijkkiđ	srijkkit
sruuviđ	sruvit
sruuváđ	sruvát
staainâh	stáinat
staaruđ	stárut
staatus	státus
staaviđ	stávit
staađâ	stáđa
stagguđ	staggut
staibâđ	staibat
staippâđ	staihppat
stajediđ	stajedit
stalliđ	stallit
stanccađ	stanccat
standiđ	standit
stappiđ	stahppit
stapâlistiđ	stapalistit
stapârâššâđ	staparaššat
starttađ	startat
statistiik	statistiik
steellig	steallit
steemmig	steapmit
steevvil	steavvil
steikkiistiđ	steihkkiistit
stelliđ	stellit
stemppâl	stemppal
steŋgiđ	steŋgit
stielâs	stealas
stiiváđ	stiivát
stijlâsâš	stijlasaš
stijváđ	stijvát
stivrejeijee	stivrejeijei
stivrim	stivrin
stivriđ	stivrit
stivrâ	stivra
stivrâkodde	stivragoddi
stiämmáđ	steapmát
stiärguđ	steargut
stoigâđ	stoigat
stokke	stohkki
stokkeriävdu	stohkkereavdu
stokkeuáivi	stohkkeoaivi
stokkođ	stohkkot
stokkádiđ	stohkkádit
stondiđ	stondit
stoohâ	stoha
stookkâđ	stohkkat
stoorgâs	storgas
stormâ	storbma
stovli	stovli
stukkâ	stuhkka
stuljiđ	stuljit
stulláá	stullá
stulččeđ	stulččet
stuorrâkietkâm	stuorrageatgan
stuorâh	stuorat
stuppâniđ	stuhppanit
sturccâđ	sturccat
sturcádâh	sturcádat
stuullâđ	stullat
stuuččâđ	stuhččat
stuárguđ	stoargut
stuárráámuš	stoarrámuš
stuárudâh	stoarudat
stuárááh	stoarát
stuárášiđ	stoarášit
stuŋgiittiđ	stuŋgiihttit
styeres	stuores
stággu	stággu
stáinâr	stáinar
stáálu	stálu
stäjediđ	stájedit
stäjideijee	stájideijei
stäjidiđ	stájidit
stänži	stánži
stääli	stáli
sudde	suddi
suddo	suddo
suddo-ollee	suddo-ollei
suddodiđ	suddodit
suddoduđ	suddodut
suddâdiđ	suddadit
sudes	sudes
suhâjäämmim	suhajápmin
suhâlâš	suhalaš
suhčâdiđ	sukčadit
suhčâdum	sukčadon
suhčâduđ	sukčadut
suibođ	suibot
suijuáivi	suijoaivi
suijâ	suija
suilottiđ	suilohttit
suitteđ	suihttet
suittuđ	suihttut
sujâhánnáá	sujahádná
sujâlâš	sujalaš
sujâttem	sujadten
sujâttiđ	sujadtit
sujâttâs	sujadtas
sukkájyelgi	suhkkájuolgi
sukkâr	suhkkar
sukkârjáávuh	suhkkarjávut
sukkârnallii	suhkkarnallii
sukkârnjaddeđ	suhkkarnjaddet
sukkârčalme	suhkkarčalbmi
suldeliđ	suldelit
suldeđ	suldet
sulgâđ	sulgat
sullâsâš	sullasaš
suládiđ	suládit
sulâstittiđ	sulastihttit
sun	sun
sundáttâllâđ	sundáhttallat
sunnuu	sudnu
suogârdiđ	suogardit
suohisuáivi	suohisoaivi
suohâd	suohat
suohâdâs	suohadas
suoi	suoi
suoivâ	suoiva
suoksâ	suoksa
suolgâi	suolgai
suolluš	suolluš
suollâgittiđ	suollagihttit
suolâ	suola
suomâkielâ	suomageala
suomâs	suomas
suomâstiđ	suomastit
suonniđ	suodnit
suonâkiäsáttâh	suonageasáhttat
suoppiđ	suohppit
suoppâinalmai	suohppainalbmai
suoppânjalmai	suohppanjalbmai
suorgiittiđ	suorgiihttit
suorgâniđ	suorganit
suorgâttiđ	suorgadtit
suorgâttâllâđ	suorgadtallat
suormâ	suorbma
suormâdâhviermi	suorbmadahvearbmi
suoskâmkumi	suoskamgumi
suoskâđ	suoskat
suotkiđ	suotgit
suotâs	suotas
suotâstâllâđ	suotastallat
suovkkâ	suovkka
suovvâđ	suovvat
suovâ	suova
suovâlodde	suovaloddi
suovâs	suovas
suovâstiđ	suovastit
suovâtivre	suovadivri
suoččâđ	suohččat
suođđâđ	suođđat
suptâ	sukta
surmâniđ	surbmanit
surmâšuđ	surbmašut
surruđ	surrut
surâdâttâđ	suradadtat
sust	sust
sutettiđ	sutehttit
sutto	suhtto
suttâdiđ	suhttadit
suttâđ	suhttat
sutâdiđ	sutadit
suuhâ	suha
suuhâđ	suhat
suulân	sulan
suulâst	sulast
suunâttâllâđ	sunadtallat
suurrâđ	surrat
suuvres	suvres
suuvrâs	suvras
suvdeđ	suvdet
suvle	suvli
suvneđ	suvdnet
suvre	suvri
suvráá	suvrá
suvrâstiđ	suvrastit
suvâttum	suvadton
suvâttuđ	suvadtut
suvčâgittiđ	suvčagihttit
suvčâgiđ	suvčagit
suábbi	soabbi
suábástiđ	soabástit
suáhudâs	soahudas
suáhuđ	soahut
suáibildiđ	soaibildit
suáibuđ	soaibut
suáittiđ	soaihttit
suájá	soajá
suájádiđ	soajádit
suáldát	soaldát
suállum	soallon
suálmudiđ	soalbmudit
suálmuđ	soalbmut
suálnum	soalnon
suálui	soalui
suáládittiđ	soaládihttit
suáládiđ	soaládit
suálágittiđ	soalágihttit
suámi	soami
suámis	soamis
suámittem	soamihtten
suámudiđ	soamudit
suámálâš	soamálaš
suánju	soanju
suáppuđ	soahpput
suápáttem	soapáhtten
suárooh	soarot
suárviluđ	soarvvilut
suárváš	soarvváš
suátialmai	soatialbmai
suávuttiđ	soavuhttit
suávvuđ	soavvut
suáđgiđ	soađgit
suáđis	soađis
suáđistittiđ	soađistihttit
syebdee	suobdei
syeini	suoini
syeiniaččinj	suoiniahččinj
syeldiđ	suoldit
syeligâs	suoligas
syelni	suolni
syemmilâš	suopmilaš
syenjir	suonjir
syergi	suorgi
syeri	suori
syfilis	syfilis
systeem	systeen
systemaatlâš	systemátlaš
sáhuttuđ	sáhuhttut
sáhánjune	sáhánjuni
sáigu	sáigu
sákku	sáhkku
sálbu-	sálbu-
sálbuttiđ	sálbuhttit
sálttáá	sáltá
sálvulâs	sálvulas
sámás	sámás
sámástiđ	sámástit
sánádâllâđ	sánádallat
sánálâš	sánálaš
sáppuđ	sáhpput
sárgum	sárgon
sárguđ	sárgut
sárnoo	sárno
sárnudiđ	sárnudit
sárnum	sárnon
sárnum-	sárnum-
sárnuttâllâđ	sárnuhttallat
sárnuđ	sárnut
sárnáá	sárná
sátku	sátgu
sáttu	sáhttu
sáttán	sáhttán
sávjáduvvâš	sávjáduvvaš
sávru	sávru
sávrudiđ	sávrudit
sávruđ	sávrut
sááhá	sáhá
sááháviđá	sáháviđá
sáávjáš	sávjáš
säggi	sággi
säiđi	sáiđi
sältittem	sáltihtten
sälttipuolâš	sáltipuolaš
sämieennâm	sámeaednan
sämikielâ	sámikeala
sämioppuu	sámiohppu
sämmilâš	sápmilaš
sänittuđ	sánihttut
säplignjuolâ	sáplignjuola
säplignjuolâs	sáplignjuolas
säpligtivgâ	sápligtivga
säppi	sáhppi
särgi	sárgi
särni	sárni
säti-	sáti-
sätináálá	sátinálá
sätioornig	sátiornit
sätitábáhtus	sátitábáhtus
sättiđ	sáhttit
sävri	sávri
sävviđ	sávvit
sävŋi	sávŋi
säältis	sáltis
säämi	sámi
sääni	sáni
säärgis	sárgis
säđgimpiäsáš	sáđgimpeasáš
ta	da
taa	dá
taabžâs	dábžas
taaijuv	dáijuv
taaiđâtyeji	dáiđaduoji
taalhâs	dálhas
taammittáá	dápmihttá
taammuđusâš	dápmuđusaš
taammâđ	dápmat
taarbâs	dárbas
taarbâš	dárbaš
taarbâšlâš	dárbašlaš
taas	dás
taat	dát
taavaakeččin	dávákehččin
taavaapeln	dávápeln
taavâs	dávas
taađaat	dáđát
tabadâllâđ	dabadallat
tabbeláhháá	dabbeláhhá
tabbeláá	dabbelá
tabediđ	dabedit
tabžâđ	dabžat
taggaar	daggár
tagopeht	dagopeht
tahhee	dahhei
taho	daho
taibâđ	daibat
taigâđ	daigat
tainâskiđ	dainaskit
takki	dahkki
takkâ	dahkka
tali	dali
tallaaš	dalláš
talle	dalli
talssiđ	dalssit
talvâsâš	dalvasaš
talvâđ	dalvat
talâstiđ	dalastit
talâttiđ	daladtit
tame	dami
tammimáánu	dapmimánu
tamâdiđ	damadit
tamâttiđ	damadtit
tamâšuđ	damašut
tane	dani
tappiittâttâđ	dahppiihttadtat
tappâ	dahppa
tapčasiđ	dapčasit
tarbâslâš	darbaslaš
tarbâšiđ	darbašit
tarbâšuđ	darbašut
tarjâđ	darjat
tarkkuđ	darkut
tarvaniđ	darvvanit
tarvettiđ	darvvehttit
tassaaš	dassáš
tast	dast
tastan	dastan
tastko	dastgo
tastmaŋa	dastmaŋa
tavaniđ	davanit
tavas	davas
tavaskulij	davaskulij
tavdâ	davda
tave	davi
tave-	dave-
tavediđ	davedit
tavemustáá	davemustá
tavepiegâpeln	davepeagabeln
tavesämikielâ	davesámikeala
tavveen	davveen
tavâsmiđ	davasmit
te	di
tebžâsiđ	debžasit
teddilemlágádâs	deddilemlágádas
teddilemviäsu	deddilemveasu
teddiliđ	deddilit
teddiđ	deddit
tedduđ	deddut
tedâččiđ	dedahččit
teedâ	deada
teehi	deahi
teejâ	deaja
teetis	deatis
tego	dego
tegu	degu
tehálâš	dehálaš
tehân	dehan
teikâ	deika
teividiđ	deividit
teivâdem	deivaden
teivâđ	deivat
tekki	dehkki
tekkis	dehkkis
tekkâ	dehkka
telefon	delefon
teltta	delta
tepčuđ	depčut
teres	deres
terestiđ	derestit
tergâd	dergat
terkkii	derkii
termi	derbmi
terppâmvuálááš	derpamvoaláš
terppâđ	derpat
terttiđ	dertit
tervi	dervi
tevduđ	devdut
tevkkâd	devkkat
tevŋâđ	devŋat
teđet	deđet
teŋkkiđ	deŋkkit
teškinjune	deikinjuni
teškâliđ	deikalit
teškâsiđ	deikasit
tibi	dibi
tie	dea
tiebbin	deabbin
tieggáár	deaggár
tiegu	deagu
tiegân	deagan
tiehu	deahu
tiellâđ	deallat
tielâdiđ	dealadit
tielâs	dealas
tiemmit	deapmit
tienuuvt	deanuvt
tieppi	deahppi
tiervi	dearvi
tiervâ	dearva
tiervâpuáttim	dearvvaboahttin
tiervâs	dearvvas
tiervâslâš	dearvvaslaš
tiervâsmiđ	dearvvasmit
tiervâttiđ	dearvvadtit
tiervâttâllâđ	dearvvadtallat
tiessân	deassan
tiestân	deastan
tiet	deat
tietogo	deatogo
tietot	deatot
tiettiđ	deahttit
tiettuđ	deahttut
tievvâđ	deavvat
tievâ	deava
tievâdâs	deavadas
tievâs	deavas
tieđe	deađi
tigge	diggi
tigguđ	diggut
tigáskiđ	digáskit
tihtâ	dihta
tihtâčällee	dihtačállei
tiiláá	diilá
tiiláđ	diilát
tiivrâs	diivras
tiivâs	diivas
tij	dij
tijdâ	dijda
tijme	dijmi
tijmepeeli	dijmepeeli
tijmá	dijmá
tikke	dihkki
tikkiistâllâđ	dihkkiistallat
tikkiđ	dihkkit
tikká	dihkká
tikkádiđ	dihkkádit
tikkâđ	dihkkat
tikso	dikso
tile	dili
tilkkáđ	dilkát
tilli	dilli
tillâ	dilla
timediđ	dimedit
times	dimes
timádâh	dimádat
timániđ	dimánit
tinttâ	dintta
tinžođ	dinžot
tipteđ	diktet
tipšo	dipšo
tipšoo	dipšo
tipšođ	dipšot
tiskáđ	diskát
tissáá	dissá
tittel	dihttel
tivriđ	divrit
tivrođ	divrot
tivrâšiđ	divrašit
tivsá	divsá
tivtâsteijee	divtasteijei
tivtâstiđ	divtastit
tivvoođ	divvot
tiäbžuđ	deabžut
tiäddoo	deaddo
tiäddu	deaddu
tiäddálâhčâđ	deaddálakčat
tiäduttiđ	deaduhttit
tiäigu	deaigu
tiäivásiđ	deaivásit
tiälgudiđ	dealgudit
tiälkku	dealku
tiälluđ	deallut
tiäláttiđ	dealáhttit
tiänás	deanás
tiänáđ	deanát
tiäppuđ	deahpput
tiätu	deatu
tiätuäŋgir	deatuáŋgir
tiäđulâš	deađulaš
tiäđust-uv	deađust-uv
tiäđustiđ	deađustit
tiäđustâllâđ	deađustallat
tiäškáđ	deaikát
tiŋgâ	diŋga
tiškâliđ	diikalit
tobbeen	dobbeen
tobdo	dobdo
tobdos	dobdos
togge	doggi
togo	dogo
togopeht	dogopeht
tohe	dohi
toho	doho
tohálâš	dohálaš
tohâluddâđ	dohaluddat
toi	doi
toideđ	doidet
toijeeđ	doijeet
toijuđ	doijut
toimâlâš	doibmalaš
toimâttâs	doibmadtas
tojâliđ	dojalit
tolcce	dolcci
tolebiššáá	dolebiššá
tolebáá	dolebá
toleláá	dolelá
tolge	dolgi
tolkker	dolker
tolliittiđ	dolliihttit
tolliđ	dollit
tolmiš	dolbmiš
tolânistiđ	dolanistit
tommit	dopmit
tommittáá	dopmihttá
tommuđusâš	dopmuđusaš
tomâliđ	domalit
ton	don
tondiet	dondeat
tonnân	dodnan
tontet	dontet
toobžâs	dobžas
toohâđ	dohat
tooleeb	doleet
tooleeh	doleet
toollâđ	dollat
toommâđ	dopmat
toorjâ	dorja
toos	dos
toossân	dossan
toovl	dovl
toovláš	dovláš
tooŋâs	doŋas
tooškâs	doikas
toperuđ	doperut
toppiittâh	dohppiihttat
toppim	dohppin
toppiđ	dohppit
toppâliđ	dohppalit
toppâđ	dohppat
topse	doksi
topsástittiđ	doksástihttit
torduu	dordu
torgâd	dorgat
torno	dorno
torvottem	dorvvohtten
toskástuttiđ	doskástuhttit
toskástuđ	doskástut
tot	dot
tottâliđ	dohttalit
toukomáánu	doukománu
tovben	dovben
tove	dovi
tovgo	dovgo
tovhon	dovhon
tovhâttep	dovhadtet
tovkos	dovkos
tovle	dovli
tovnpel	dovnpel
tovnpeln	dovnpeln
tovváá	dovvá
továdâh	dovádat
tovâdâs	dovadas
tovâdâttâđ	dovadadtat
tovâldâh	dovaldat
tovâttiđ	dovadtit
toškâliđ	doikalit
tubbáák	dubbák
tubduđ	dubdut
tubdâmettum	dubdamehtton
tubdâmuš	dubdamuš
tubdâttiđ	dubdadtit
tubdâttâs	dubdadtas
tuhhiittettee	duhhiihttehttei
tuhhiđ	duhhit
tuhlediđ	duhledit
tuhlár	duhlár
tuhme	duhmi
tuidâččiđ	duidahččit
tuigestiđ	duigestit
tuihme	duihmi
tukki	duhkki
tulcce	dulcci
tulccodiđ	dulccodit
tulccođ	dulccot
tulkkuđ	dulkut
tulkkâdijjee	dulkadijjei
tulkkâdijjeevuotâ	dulkadijjeevuohta
tulkkâđ	dulkat
tullijâš	dullijaš
tullâ	dulla
tullâräddi	dullaráddi
tullâsaje	dullasaji
tullâsäggi	dullasággi
tullâtuosâs	dulladuosas
tulve	dulvi
tulvâdiđ	dulvadit
tume	dumi
tumediđ	dumedit
tun	dun
tunhân	dunhan
tunnâ	dudna
tuo	duo
tuodâr	duodar
tuodârvälli	duodarvválli
tuogu	duogu
tuohun	duohun
tuoi	duoi
tuoijuđ	duoijut
tuolbâs	duolbas
tuoldâttiđ	duoldadtit
tuoldâđ	duoldat
tuolmâm	duolbman
tuolmâmmaašin	duolbmapmášin
tuolvii	duolvii
tuolvâdiđ	duolvadit
tuolvânurde	duolvanurdi
tuolvâs	duolvas
tuombel	duombel
tuommiittâttâđ	duopmiihttadtat
tuommiđ	duopmit
tuommuđusâš	duopmuđusaš
tuonârokke	duonarohkki
tuonâš	duonaš
tuoppiđ	duohppit
tuoppâđ	duohppat
tuopâluđ	duopalut
tuorgiđ	duorgit
tuorgâ	duorga
tuorrâđ	duorrat
tuorâldâh	duoraldat
tuorâstâh	duorastat
tuostâđ	duostat
tuosâs	duosas
tuot	duot
tuotâ	duota
tuovŋâs	duovŋas
tuovŋâđ	duovŋat
tuovŋâštiđ	duovŋaitit
tuođee	duođei
tuođâi	duođai
tuođâlâš	duođalaš
tuođâst	duođast
tuođâšteijee	duođaiteijei
tupe	dupi
tupekálvu	dupekálvu
tupepiällást	dupepeallást
tuppáđ	duhppát
tuppâniđ	duhppanit
turbođ	durbot
turde	durdi
ture	duri
turedâttâđ	duredadtat
turge	durgi
turgediđ	durgedit
turgi	durgi
turgâliđ	durgalit
turkkâliđ	durkalit
turnuu	durnu
turppáđ	durpát
turráá	durrá
turviđ	durvvit
turvâstiđ	durvvastit
turâstâh	durastat
turâštiđ	duraitit
tutkâm	dutgan
tutkâmuš	dutgamuš
tutkâđ	dutgat
tutâdiđ	dutadit
tutâmettum	dutamehtton
tuubdâm	dubdan
tuubdâs	dubdas
tuulâš	dulaš
tuumá	dumá
tuumásâš	dumásaš
tuuppâđ	duhppat
tuuršalm	duršaln
tuuvdâ	duvda
tuuvááš	duváš
tuuŋŋâđ	duŋŋat
tuvdeđ	duvdet
tuveluđ	duvelut
tuvkkâliđ	duvkkalit
tuvne	duvdni
tuádduđ	doaddut
tuággáá	doaggá
tuággáár	doaggár
tuáhkuđ	doahgut
tuáhtár	doahtár
tuáhunteehin	doahunteehin
tuáhá	doahá
tuáhánväldiđ	doahánváldit
tuáhásis	doahásis
tuáijár	doaijár
tuáistáážân	doaistážan
tuáivu	doaivu
tuáivuttiđ	doaivuhttit
tuáivuđ	doaivut
tuájáruššâđ	doajáruššat
tuájásiđ	doajásit
tuákki	doahkki
tuákkuđ	doahkkut
tuálbus	doalbus
tuálikyerree	doalikuorrei
tuálvuđ	doalvut
tuámittiđ	doamihttit
tuámmir	doapmir
tuáppuđ	doahpput
tuápsáđ	doaksát
tuápulâs	doapulas
tuápán	doapán
tuápánjâš	doapánjaš
tuárbumpeeli	doarbumpeeli
tuárgistiđ	doargistit
tuárgu	doargu
tuárgástâs	doargástas
tuáridiđ	doaridit
tuárjuđ	doarjut
tuárruđ	doarrut
tuáruttiđ	doaruhttit
tuárvi	doarvi
tuárván	doarvván
tuáráskiđ	doaráskit
tuástuđ	doastut
tuávkki	doavkki
tuávuštiđ	doavuitit
tuávváš	doavváš
tuávŋi	doavŋi
tuávŋis	doavŋis
tuávŋáá	doavŋá
tuáŋgi	doaŋgi
tuáŋguđ	doaŋgut
tuáŋgáá	doaŋgá
tuđhos	duđhos
tuđâttiđ	duđadtit
tuŋgijâš	duŋgijaš
tuš	duš
tuše	duši
tuškâ	duika
tuškâliđ	duikalit
tušášiđ	dušášit
tušše	dušši
tuššâdeijee	duššadeijei
tuššâđ	duššat
tyebbiláhháá	duobbiláhhá
tyebbiláá	duobbilá
tyebbin	duobbin
tyejettem	duojehtten
tyeji	duoji
tyejikooskâst	duojikoskast
tyejiniävvu	duojineavvu
tyejiolmooš	duojiolbmoš
tyejipiergâs	duojipeargas
tyejičeppi	duojičehppi
tyelji	duolji
tyellittälli	duollihttálli
tyemmejuđ	duopmejut
tyestil	duostil
tábbániđ	dábbánit
tábáhtuđ	dábáhtut
tággáár	dággár
táh	dát
táiguđ	dáigut
táiđu	dáiđu
tájuttiđ	dájuhttit
tákkudiđ	dáhkkudit
tálhudiđ	dálhudit
tálkkuđ	dálkut
tálustâllâđ	dálustallat
tálutuálu	dálutoalu
tálvádittiđ	dálvádihttit
tálvádiđ	dálvádit
tálváduđ	dálvádut
tálvádâh	dálvádat
tánávt	dánávt
táppu	dáhppu
táppáđ	dáhppát
tápádiđ	dápádit
tápáduđ	dápádut
tárbu	dárbu
tárbulâš	dárbulaš
tárguttiđ	dárguhttit
tárkká	dárká
tármuttuđ	dárbmuhttut
tárukielâ	dárukeala
tástán	dástán
táttu	dáhttu
táttuđ	dáhttut
tátulis	dátulis
tátulâd	dátulat
tátulân	dátulan
távgáá	dávgá
távjá	dávjá
táválâš	dáválaš
távástâh	dávástat
táágu	dágu
táágupeht	dágupeht
tááibus	dáibus
táálu	dálu
táárbu	dárbu
táárus	dárus
táássán	dássán
táássáš	dássáš
táávgáš	dávgáš
tâi	dai
täbbiláhháá	dábbiláhhá
täbbiláá	dábbilá
täbidiđ	dábidit
tähti	dáhti
tähtikargâdâs	dáhtikargadas
täigi	dáigi
täiđiđ	dáiđit
täkki	dáhkki
tälvi	dálvi
tälvikuáttum	dálvikoahtton
tälviv	dálviv
tämmit	dápmit
täpidiđ	dápidit
täst oovdâs	dást ovdas
tästoovdâs	dástovdas
tästpalij	dástpalij
tävgi	dávgi
tävistiđ	dávistit
tävjit-távjá	dávjit-távjá
tääbbin	dábbin
tääpi	dápi
tääsi	dási
tääsniluččim	dásniluhččin
täässiv	dássiv
täävis	dávis
täävjib	dávjit
täävvir	dávvir
ubbuđ	ubbut
ubbâ	ubba
ubbâalme	ubbálbmi
ubbâarve	ubbárvi
ubbâlaggâ	ubbalagga
ubbâlággá	ubbalággá
ubbân	ubban
ubbâraddekyeli	ubbaraddekuoli
ubbâraddâ	ubbaradda
ubbâčuáli	ubbačoali
ubâ	uba
ubâlâš	ubalaš
ubâlâšvuođâ	ubalašvuođa
ucce	uhcci
ucceeb	uhcceet
uccániđ	uhccánit
uccást	uhccást
uccáá	uhccá
uccáávuoijii	uhccávuoijii
uccâkietkâm	uhccageatgan
ucemussân	ucemussan
ucemustáá	ucemustá
ucánjii	ucánjii
ucástittiđ	ucástihttit
ucástâddâđ	ucástaddat
ucášiđ	ucášit
ucâliđ	ucalit
uddo	uddo
uhke	uhgi
uhkediđ	uhgedit
uhkáástâllâđ	uhgástallat
uigâdiđ	uigadit
uigâdâttâđ	uigadadtat
uigâđ	uigat
uine	uini
uinođ	uinot
uináástâllâđ	uinástallat
uinášiđ	uinášit
ujo	ujo
ujostâllâđ	ujostallat
uksâ	uksa
ulgâ	ulga
ulme	ulbmi
uládiđ	uládit
uládâddâđ	uládaddat
ulâttimmuddo	uladtipmuddo
ummool	upmol
umogâš	umogaš
umolâš	umolaš
umásistiđ	umásistit
umástistiđ	umástistit
umástittiđ	umástihttit
umástiđ	umástit
unohistiđ	unohistit
unohâs	unohas
urbe	urbi
urbijâš	urbijaš
urbiâš	urbiaš
urkko	urko
uskiđ	uskit
ustev	ustev
usâdiđ	usadit
usâdâttâđ	usadadtat
usâstâllâđ	usastallat
usâttiđ	usadtit
usâttâllâđ	usadtallat
utke	utgi
uubbâlm	ubbaln
uubâs	ubas
uuccâđ	uhccat
uulguš	ulguš
uumâs	umas
uundâr	undar
uussâđ	ussat
uuđâg	uđat
uuštâorrâ	uitaorra
uvjiđ	uvjit
uvjâluđ	uvjalut
uvjâlágán	uvjalágán
uvnâ	uvdna
uvástâllâđ	uvástallat
uábbi	oabbi
uáccáá	oahccá
uággi	oaggi
uáhti	oahti
uáhuđ	oahut
uáinihinnáá	oainihidná
uáinimettum	oainimehtton
uáinimčiehâ	oainimčeaha
uáinistiđ	oainistit
uáinistiškyettiđ	oainistiikuohttit
uáiniđ	oainit
uáinojeijee	oainojeijei
uáinu	oainu
uáinulijn	oainulijn
uáinulâš	oainulaš
uáinus	oainus
uáinusist	oainusist
uáinusân	oainusan
uáináh	oainát
uáináttâh	oaináhttat
uáivi	oaivi
uáivil	oaivil
uáivildiđ	oaivildit
uáiviomâdâh	oaiviomadat
uáiviskálžu	oaiviskálžu
uáivist	oaivist
uáivitähti	oaivitáhti
uáiviäšši	oaiveašši
uáivuš	oaivuš
uáiváduđ	oaivádut
uáivádâh	oaivádat
uáiváá	oaivá
uáiváš	oaiváš
uálgis	oalgis
uálgispeeli	oalgispeeli
uálgispeln	oalgispeln
uálguáivsollâ	oalgoaivsolla
uálgádistiđ	oalgádistit
uálgátuáivi	oalgátoaivi
uálgâtuáivi	oalgadoaivi
uáli	oali
uálul	oalul
uámikkâs	oamihkkas
uámis	oamis
uáneeh	oaneet
uánihissii	oanihissii
uániháá	oanihá
uápis	oapis
uápisteijee	oapisteijei
uápistem	oapisten
uápistiđ	oapistit
uápásmiđ	oapásmit
uápásmuđ	oapásmut
uárbimpeeli	oarbimpeeli
uárbišmâš	oarbišmaš
uárbášnjâš	oarbášnjaš
uárbâš	oarbaš
uári	oari
uárji	oarji
uárjibeln	oarjibeln
uármušm	oarbmušn
uási	oasi
uásittem	oasihtten
uásittemesvuotâ	oasihttemesvuohta
uástee	oastei
uástiđ	oastit
uástu	oastu
uástuergi	oastuergi
uástus	oastus
uásus	oasus
uásálâš	oasálaš
uásálâšvuotâ	oasálašvuohta
uávuttiđ	oavuhttit
uávuttâllâđ	oavuhttallat
uávŋild	oavŋilt
uáđđimilddee	oađđimilddei
uáđđimkuárvi	oađđimgoarvi
uáđđimviste	oađđimvisti
uáđđiđ	oađđit
uáđđiđ háccá	oađđiđ háhccá
uáđđáástâllâđ	oađđástallat
uáđđáđ	oađđát
uážittem	oažihtten
uážittuđ	oažihttut
uážudiđ	oažudit
uážži	oažži
uážžuđ	oažžut
uđamâg	uđamat
uđhettem	uđhehtten
uđâgâš	uđagaš
uđâsmittiđ	uđasmihttit
uđâsmittuđ	uđasmihttut
uđâstiđ	uđastit
uđđâalmai	uđđálbmai
uđđâivemáánu	uđđaivemánu
uškestiđ	uikestit
ušteđ	uitet
uštâččiđ	uitahččit
vaahâg	váhat
vaahâglâš	váhaglaš
vaaibâs	váibas
vaaljah	váljat
vaaljapeivi	váljapeivi
vaalmâš	válbmaš
vaalâ	vála
vaannâđ	vádnat
vaareeh	váreet
vaarrâđ	várrat
vaarâ	vára
vaastâ	vásta
vaattâđ	váhttat
vaccâpeeli	vahccabeeli
vadâstuđ	vadastut
vagge	vaggi
vahaduttiđ	vahaduhttit
vahe	vahi
vahtâ	vahta
vahâgist	vahagist
vahâgittiđ	vahagihttit
vaibâdiđ	vaibadit
vaibâm	vaiban
vaibâđ	vaibat
vaidâliđ	vaidalit
vaidâlus	vaidalus
vaigâd	vaigat
vaijaa	vaijá
vaijeeđ	vaijeet
vaimuu	vaibmu
vainâgiđ	vainagit
vajaskiđ	vajaskit
vajediđ	vajedit
vajâgâššâđ	vajagaššat
vajâldiđ	vajaldit
vakšum	vakšon
vakšuđ	vakšut
val	val
vala	vala
vala-uv	vala-uv
valduđ	valdut
valdâttâllâđ	valdadtallat
vale	vali
valgâmkuákki	valgamgoahkki
valgâniđ	valganit
valgâđ	valgat
valjeeht	valjeeht
valjeest	valjeest
valjimiähtu	valjimeahtu
valjimiävtulâš	valjimeavtulaš
valjiđ	valjit
valjâpeivi	valjabeivi
vallii	vallii
valmiđ	valbmit
valmâštiđ	valbmaitit
valmâštuđ	valbmaitut
valâdiđ	valadit
vandârdiđ	vandardit
vanettiđ	vanehttit
vantteđ	vanttet
vanttâ	vantta
vardađ	vardat
vardeđ	vardet
vardeškyettiđ	vardeikuohttit
vardâččiđ	vardahččit
vargiittiđ	vargiihttit
varriistâllâđ	varriistallat
varriđ	varrit
vaskuvváđ	vaskuvvát
vaskuđ	vaskut
vaskâttâh	vaskadtat
vaskâđ	vaskat
vasta	vasta
vavijdiđ	vavijdit
vavjuđ	vavjut
vazâččiđ	vazahččit
vašo	vašo
veddi	veddi
veddiđ	veddit
vedduđ	veddut
vedissnäldee	vedissnáldei
veeddâh	veaddat
veedis	veadis
veejeeh	veajeet
veeleeh	vealeet
veelâ	veala
veeppâđ	veahppat
veerdi	veardi
veerdiš	veardiš
veerdižeh	veardižet
veeri	veari
veerrin	vearrin
veessil	veassil
veeđđuđ	veađđut
veeđđâđ	veađđat
veigi	veigi
veikkâ	veihkka
veitâlâs	veitalas
veitâlâsâst	veitalasast
vejehâš	vejehaš
vekittiđ	vekihttit
vekki	vehkki
velgalmai	velgalbmai
velgi	velgi
velgus	velgus
velmâsâš	velbmasaš
veltta	velta
velttiđ	veltit
velttâđ	veltat
velčittiđ	velčihttit
verd	vert
verdidiđ	verdidit
verivuotâ	verivuohta
verkkâ	verka
verstâ	versta
verájâš	verájaš
verâstâh	verastat
verâttiđ	veradtit
verâttâh	veradtat
verâttâs	veradtas
vest	vest
vestiđ	vestit
vety	vety
vevâldâh	vevaldat
veđâttâh	veđadtat
vicárâh	vicárat
viehuv	veahuv
viehâ	veaha
viehâkoolvâ	veahagolva
viekkejeijee	veahkkejeijei
viekkiistâllâđ	veahkkiistallat
viekkiittiđ	veahkkiihttit
viekkimpiergâs	veahkkimpeargas
viekkiđ	veahkkit
vieksâ	veaksa
vielgâd	vealgat
vielpis	vealpis
viemâr	veamar
viemârdâs	veamardas
viennâđ	veadnat
vienâliđ	veanalit
vienâlâs	veanalas
vierccâ	vearcca
vierccâdâh	vearccadat
vieres	veares
vieresolmooš	vearesolbmoš
viermi	vearbmi
vierrâđ	vearrat
vierâdekes	vearadekes
vierâdeves	vearadeves
vierâdiđ	vearadit
vierâduves	vearaduves
vierâlittiđ	vearalihttit
vierâliđ	vearalit
vierâlâttâđ	vearaladtat
viessâđ	veassat
viestârpeln	veastarpeln
vievâst	veavast
vievâttâllâđ	veavadtallat
vieškâđ	veaikat
viežâdiđ	veažadit
viežži	veažži
viežžâliđ	veažžalit
viežžâđ	veažžat
vigguđ	viggut
viggâđ	viggat
vigâdâttâđ	vigadadtat
vigâttiđ	vigadtit
vihkuđ	vihgut
vihkâm	vihgan
viijses	viijses
viildâs	viildas
viini	viini
viippâđ	viihppat
viirrâđ	viirrat
viisut	viisut
viittân	viihttan
viiđgâs	viiđgas
viiđâs	viiđas
viiššâđ	viiššat
vijdodâh	vijdodat
vijláđ	vijlát
vijme	vijmi
vijnáttuđ	vijnáhttut
vijve	vijvi
vijváin	vijváin
vijđediđ	vijđedit
vijđáht	vijđáht
vijđániđ	vijđánit
vijđásávt	vijđásávt
vildáá	vildá
viljâpeeli	viljabeeli
vilpâstiđ	vilpastit
vilšostiđ	vilšostit
vilšâstiđ	vilšastit
vilššeđ	vilššet
vilššâliđ	vilššalit
vinjádiđ	vinjádit
vinnood	vidnot
vintti	vintti
vinálistiđ	vinálistit
vipšâdiđ	vipšadit
vipšâđ	vipšat
virde	virdi
virge	virgi
virgeolmooš	virgeolbmoš
virgeomâhâš	virgeomahaš
virgettuđ	virgehttut
virkoduđ	virkodut
virkosmiđ	virkosmit
virâttiđ	viradtit
viskodiđ	viskodit
viskâd	viskat
visseeh	visseet
vissásávt	vissásávt
vissâ	vissa
vist	vist
viste	visti
vistekálvu	vistekálvu
visteđ	vistet
vistig	vistit
visârdiđ	visardit
vittii	vihttii
vittá	vihttá
vittádiđ	vihttádit
vittáduđ	vihttádut
vittâ	vihtta
vivvâpeeli	vivvabeeli
viäddáš	veaddáš
viäkkáá	veahkká
viälgudiđ	vealgudit
viälguh	vealgut
viälgulâš	vealgulaš
viälgáduđ	vealgádut
viälgádâttâđ	vealgádadtat
viälgás	vealgás
viälgáđ	vealgát
viälgášiđ	vealgášit
viälláđ	veallát
viälmá	vealbmá
viälpáttiđ	vealpáhttit
viälániđ	vealánit
viälčáttiđ	vealčáhttit
viärdágâš	veardágaš
viärdásâš	veardásaš
viärju	vearju
viärmádâh	vearbmádat
viärráá	vearrá
viäruiolmooš	vearuiolbmoš
viäsku	veasku
viäsu	veasu
viättu	veahttu
viätu	veatu
viäđŋásâš	veađŋásaš
vičálistiđ	vičálistit
viđjân-kuđjân	viđjan-kuđjan
viđá	viđá
viššâl	viššal
vižáskiđ	vižáskit
vižástâllâđ	vižástallat
vižže	vižži
volliittiđ	volliihttit
vonnâliđ	vodnalit
vonâlistiđ	vonalistit
vonâttiđ	vonadtit
voohâd	vohat
vooijâđ	voijat
voojiš	vojiš
voonâs	vonas
vorrâ	vorra
vorrâciccâlâs	vorracihccalas
vorrâcipâlâs	vorracipalas
voskâstiđ	voskastit
vovdâdiđ	vovdadit
vovdâđ	vovdat
vođđâ	vođđa
vošmâ	vošma
vošmâdiđ	vošmadit
vuobzâ	vuobza
vuod	vuot
vuodâ	vuoda
vuoggâ	vuogga
vuoggâčielgi	vuoggačealgi
vuohâd	vuohat
vuoi	vuoi
vuoidâliđ	vuoidalit
vuoidâstiđ	vuoidastit
vuoidâđ	vuoidat
vuoigist	vuoigist
vuoigiđ	vuoigit
vuoigâ	vuoiga
vuoigâdvuotâ	vuoigadvuohta
vuoijâđ	vuoijat
vuoivâšmeh	vuoivašmet
vuoiŋâ	vuoiŋa
vuoiŋâstempuddâ	vuoiŋastempudda
vuoiŋâstiđ	vuoiŋastit
vuoiŋâšeh	vuoiŋašet
vuojâ	vuoja
vuojâdeijee	vuojadeijei
vuojâdâttâđ	vuojadadtat
vuojâliđ	vuojalit
vuojâstiđ	vuojastit
vuojâttem	vuojadten
vuojâttes	vuojadtes
vuojâttiđ	vuojadtit
vuojâččiđ	vuojahččit
vuolgâ	vuolga
vuolgâdiđ	vuolgadit
vuolgâttâs	vuolgadtas
vuolâstiđ	vuolastit
vuolâttâs	vuoladtas
vuommâd	vuopmat
vuomâ	vuoma
vuonjâ	vuonja
vuonjâl	vuonjal
vuonâ	vuona
vuoppeeli	vuohppeeli
vuoppâ	vuohppa
vuopsâ	vuoksa
vuoptuáivkuálsi	vuoktoaivkoalsi
vuoptâ	vuokta
vuoptâkonnâ	vuoktagodna
vuoptâčalme	vuoktačalbmi
vuoptâčeppi	vuoktačehppi
vuordâs	vuordas
vuorjâđ	vuorjat
vuorkkiistâllâđ	vuorkiistallat
vuorkkiđ	vuorkit
vuorrâđ	vuorrat
vuorâs	vuoras
vuorâsolmooš	vuorasolbmoš
vuorâččâsmyerji	vuorahččasmuorji
vuosmuš	vuosmuš
vuosmuštáá	vuosmuitá
vuossâmustáá	vuossamustá
vuostiđ	vuostit
vuosâ	vuosa
vuosâsaajeest	vuosasájeest
vuosâsajasávt	vuosasajasávt
vuotkâ	vuotga
vuottuđ	vuohttut
vuovâs	vuovas
vuoččin	vuohččin
vuođgâliđ	vuođgalit
vuoššâđ	vuoššat
vuáhuđ	voahut
vuáháduđ	voahádut
vuáhádâh	voahádat
vuáijuđ áášán	voaijuđ ášán
vuáimástâllâm	voaibmástallan
vuáimáá	voaibmá
vuáisá	voaisá
vuáisádâttâđ	voaisádadtat
vuáittu	voaihttu
vuáju	voaju
vuájáán	voaján
vuáksá	voaksá
vuálgámuš	voalgámuš
vuálppu	voalpu
vuáládâs	voaládas
vuálás	voalás
vuáláskulij	voaláskulij
vuálásoivij	voalásoivij
vuálááš	voaláš
vuámášiđ	voamášit
vuáppuđ	voahpput
vuápsuđ	voaksut
vuárbuđ	voarbut
vuárbádiđ	voarbádit
vuárhudiđ	voarhudit
vuárkká	voarká
vuárnum	voarnon
vuárádâh	voarádat
vuástá	voastá
vuástálistiđ	voastálistit
vuásádâh	voasádat
vuáttuđ	voahttut
vuátádâh	voatádat
vuávdáá	voavdá
vuávnum	voavdnon
vuávnuđ	voavdnut
vuáválâšvuotâ	voaválašvuohta
vuáváámeh	voavámet
vuáváđ	voavát
vuáčču	voahčču
vuáđu	voađu
vuáđudâs	voađudas
vuáđujuurdâ	voađujurda
vuáđuld	voađult
vuáđuomâdâh	voađuomadat
vuáđustiđ	voađustit
vuáŋŋáš	voaŋŋáš
vuážáskiđ	voažáskit
vuážžuđ	voažžut
vyebdee	vuobdei
vyebdiđ	vuobdit
vyebziđ	vuobzit
vyehi	vuohi
vyeijee	vuoijei
vyeijiliđ	vuoijilit
vyeijim	vuoijin
vyeijimergi	vuoijimergi
vyeijiđ	vuoijit
vyeimi	vuoibmi
vyeimittem	vuoibmihtten
vyeimittuđ	vuoibmihttut
vyeitittâttâđ	vuoitihttadtat
vyeittiđ	vuoihttit
vyejettem	vuojehtten
vyejettiđ	vuojehttit
vyeldihaŋgâ	vuoldihaŋga
vyelebâš	vuolebaš
vyelediđ	vuoledit
vyeleeb	vuoleet
vyelgim	vuolgin
vyelgiđ	vuolgit
vyeligâsâst	vuoligasast
vyeligâš	vuoligaš
vyelikerdi	vuolikerdi
vyelni	vuolni
vyemi	vuomi
vyene	vuoni
vyeneppeeli	vuonehppeeli
vyeppee	vuohppei
vyepsi	vuoksi
vyerbi	vuorbi
vyernis	vuornis
vyesi	vuosi
vyesih	vuosit
vyesimáánu	vuosimánu
vyestilistiđ	vuostilistit
vyestitiäddu	vuostiteaddu
vyesvis	vuosvis
vyesvisttijjee	vuosvisttijjei
vyetkiđ	vuotgit
vyettiđ	vuohttit
vyevdi	vuovdi
vyeveers	vuoveers
vyevsistuđ	vuovsistut
vyevsittiđ	vuovsihttit
vyežži	vuožži
váddu	váddu
váhá	váhá
váidámuš	váidámuš
váiluđ	váilut
váimu	váibmu
váimulâš	váibmulaš
váimuskâddâđ	váibmuskaddat
váimuttem	váibmuhtten
váivástuđ	váivástut
váiváá	váivá
váivášiđ	váivášit
vájáldittiđ	vájáldihttit
válduomâdâh	válduomadat
válduäšši	válduášši
váldučuákkim	váldučoahkkin
váldáttiđ	váldáhttit
válfár	válfár
válkká	válká
válvuđ	válvut
vánášiđ	vánášit
várváđ	várvvát
váráduđ	várádut
várás	várás
vástádâs	vástádas
vátávâš	vátávaš
vázzálittiđ	vázzálihttit
vázáldittiđ	vázáldihttit
váá	vá
váádduh	váddut
vááijuvvuotâ	váijuvvuohta
vááimu	váibmu
vááimus	váibmus
vááimuvuálááš	váibmuvoaláš
vááldus	váldus
váánnuđ	vádnut
váárdus	várdus
vâi	vai
vâik	vaik
vädisvuotâ	vádisvuohta
väidim	váidin
väidiđ	váidit
väimil	váibmil
väivi	váivi
väldi-ištâmsaje	váldi-iitamsaji
väldičokkámsaje	váldičohkkámsaji
väldiđ	váldit
vänivuotâ	vánivuohta
värdistiđ	várdistit
väri	vári
västideijee	vástideijei
vättee	váhttei
vätti	váhtti
vävjee	vávjei
vävjiđ	vávjit
väzzilistiđ	vázzilistit
väzziliđ	vázzilit
väzziđ	vázzit
väädis	vádis
vääiviht	váiviht
vääni	váni
väänis	vánis
vääri	vári
väättiđ	váhttit
áhásiđ	áhásit
áhčááttâllâđ	ákčáhttallat
áhšu	áhšu
áiculâš	áiculaš
áigumuš	áigumuš
áiguđ	áigut
áigádâh	áigádat
áigápuátu	áigápoatu
áigáá	áigá
áijuh	áijut
áimu	áibmu
áimudiđ	áibmudit
áimumolsoo	áibmumolso
áimučavos	áibmučavos
áiru	áiru
ájánem	ájánen
ájániđ	ájánit
ájánâddâđ	ájánaddat
ájánâs	ájánas
ájáttâs	ájáhttas
ákku	áhkku
ákkuv	áhkkuv
ákkuváš	áhkkuváš
ákšu	ákšu
áldu	áldu
álduduh	áldudut
álgu	álgu
álššáá	álššá
ánhástuššâđ	ánhástuššat
ánnoo	ádno
ánssu	ánssu
ánsášiđ	ánsášit
ánulâs	ánulas
ánuttiđ	ánuhttit
áná	áná
áppádiđ	áhppádit
áppáá	áhppá
ápálâš	ápálaš
árdukááđus	árdukáđus
árgudiđ	árgudit
árgášiđ	árgášit
árkku	árku
árppu	árpu
árvu-uásus	árvu-oasus
árvulâš	árvvulaš
árvunommâ	árvvunopma
árvusâš	árvvusaš
árvuttem	árvvuhtten
árvuttuššâđ	árvvuhttuššat
árvuttâššâđ	árvvuhttaššat
árvuštellee	árvvuitellei
árvuštâllâm	árvvuitallan
árvuštâllâđ	árvvuitallat
árvádus	árvvádus
ávhuttiđ	ávhuhttit
ávhálâš	ávhálaš
ávhástâllâđ	ávhástallat
ávhâstâllâđ	ávhastallat
ávjukyeddee	ávjukuoddei
ávjuđ	ávjut
ávládiđ	ávládit
ávskár	ávskár
ávudiđ	ávudit
ávus	ávus
ávuskyeimi	ávuskuoibmi
ávusmielâlâš	ávusmealalaš
ávustiđ	ávustit
ávutuáluh	ávutoalut
ááhuš	áhuš
ááijuv	áijuv
áálááš	áláš
áámmátškovlâ	ápmátškovla
áánnuđ	ádnut
ááru	áru
áávus	ávus
áŋkkár	áŋkkár
áštáluhčâđ	áitálukčat
áštášiđ	áitášit
ášálâš	ášálaš
ášáskuttiđ	ášáskuhttit
ášásteijee	ášásteijei
áššu	áššu
äggee	ággei
äggil	ággil
ähtiđ	áhtit
äigi	áigi
äigipaje	áigipaji
äigitavlu	áigitavlu
äigiájánâs	áigiájánas
äigiääji	áigeaáji
äijih	áijit
äijihtävgi	áijihtávgi
äimi	áibmi
äimijieŋâ	áibmijeaŋa
äiminjune	áibminjuni
äimišalme	áibmišalbmi
äiniväldi	áiniváldi
äitti	áihtti
äiđiuksâ	áiđiuksa
äjittiđ	ájihttit
äksioon	áksion
älgiđ	álgit
älkkee	álkei
älššidiđ	álššidit
äpittem	ápihtten
äpittuđ	ápihttut
äpituhtuu	ápituhtu
äppi	áhppi
ärbi	árbi
ärbisääni	árbisáni
ärgi	árgi
ärttig	ártit
ärvidiđ	árvvidit
ässee	ássei
ässeeloho	ásseeloho
ävkki	ávkki
ävttiđ	ávttit
ävđee	ávđei
ävđin	ávđin
ävži	ávži
ääbir	ábir
ääigikolo	áigikolo
ääigild	áigilt
ääigiájánâs	áigiájánas
ääigiääji	áigeaáji
ääijiđ	áijit
ääinig	áinit
ääiđis	áiđis
ääji	áji
ääldis	áldis
ääli	áli
äämmil	ápmil
äänhis	ánhis
ääpih	ápit
äätis	átis
äävild	ávilt
ääččiv	áhččiv
ääši kirjálâs čielgim	áši kirjálas čealgin
äčiváš	áčiváš
äŋgir	áŋgir
äŋgiruššâđ	áŋgiruššat
äŋgirâššâđ	áŋgiraššat
äšittem	ášihtten
äštim	áitin
äštiđ	áitit
äšši	ášši
äššigâs	áššigas
äššikirje	áššikirji
čaacciđ	čáhccit
čaacâ	čáca
čaahâđ	čáhat
čaaitâlm	čáitaln
čaaitâlmuási	čáitalbmoasi
čaalgâhvyesi	čálgahvuosi
čaalluđ	čállut
čaalâ	čála
čaavdes	čávdes
čabbin	čabbin
čahhiđ	čahhit
čaittâleijee	čaihttaleijei
čaittâlem	čaihttalen
čaittâlemlyevi	čaihttalemluovi
čaittâlemsaje	čaihttalemsaji
čaittâliđ	čaihttalit
čaittâluhčâm	čaihttalukčan
čaitâlmâs	čaitalbmas
čaitâččem	čaitahččen
čalgettiđ	čalgehttit
čalgâđ	čalgat
čalmadiđ	čalbmadit
čalmastuđ	čalbmastut
čalme	čalbmi
čalmekollááš	čalbmekolláš
čalmekulme	čalbmekulbmi
čalmettem	čalbmehtten
čalmettesvuotâ	čalbmehttesvuohta
čalmeuási	čalbmeoasi
čalmevárdái	čalbmevárdái
čaraniđ	čaranit
čarviistiđ	čarviistit
čarviistâllâđ	čarviistallat
čarviittiđ	čarviihttit
čarviittoh	čarviihttot
čarviđ	čarvvit
časkaldâh	časkaldat
časkastuh	časkastut
časkattoh	časkahttot
časkel	časkel
časkeliđ	časkelit
časkes	časkes
časkestiđ	časkestit
časkettiđ	časkehttit
časkeđ	časket
časkâdiđ	časkadit
časkâttiđ	časkadtit
čavos	čavos
čađadâs	čađadas
čee	čei
čeeci	čeaci
čeeppiht	čeahppiht
čeergâ	čearga
čeerrih	čearrit
čeksâ	čeksa
čepibiššááht	čepibiššáht
čeppi	čehppi
čeppivuotâ	čehppivuohta
čerediđ	čeredit
čergiittiđ	čergiihttit
čergiđ	čergit
čergâ	čerga
čergâdiđ	čergadit
čergâmuotâ	čergamuota
čergâstiđ	čergastit
čergâsčalme	čergasčalbmi
čergâđ	čergat
čerrihkyeli	čerrihguoli
čevelijne	čevelijni
čevenävdi	čevenávdi
čevni	čevdni
čevârdiđ	čevardit
čevđi	čevđi
čevžisuonâ	čevžisuona
čibástâllâđ	čibástallat
čiehhuđ	čeahhut
čiehâ	čeaha
čiehâkappeer	čeahagahppeer
čiehâliđ	čeahalit
čiehâđ	čeahat
čiehčâsiđ	čeakčasit
čiehčâđ	čeakčat
čielgi	čealgi
čielgiittâs	čealgiihttas
čielgiđ	čealgit
čielgâdiđ	čealgadit
čielgâdâs	čealgadas
čielgâs	čealgas
čielgâsmittiđ	čealgasmihttit
čielgâđ	čealgat
čiermih	čearbmit
čiermihât	čearbmihat
čierri	čearri
čierrih	čearrit
čierâstiđ	čearastit
čierâstâllâđ	čearastallat
čieskâs	čeaskas
čieskâđ	čeaskat
čievâdiđ	čeavadit
čievârdiđ	čeavardit
čievâstiđ	čeavastit
čievčâstâttâđ	čeavčastadtat
čievčâttâllâđ	čeavčadtallat
čievčâttâttâđ	čeavčadtadtat
čieŋâl	čeaŋal
čihtuđ	čihtut
čihtâmkiäpu	čihtamgeapu
čihtâđ	čihtat
čiimâs	čiibmas
čikâlâs	čikalas
čimmâ	čipma
činehumtavdâ	činehumdavda
činehuđ	činehut
čipteđ	čiktet
čirgottâs	čirgohttas
čirgođ	čirgot
čirgáđ	čirgát
čivgâ	čivga
čivgâđ	čivgat
čivroduđ	čivrodut
čivtâttiđ	čivtadtit
čiähádettee	čeahádehttei
čiähádâttâđ	čeahádadtat
čiähániđ	čeahánit
čiäkkáriđ	čeahkkárit
čiäppudâh	čeahppudat
čiäppuđ	čeahpput
čiäpášiđ	čeapášit
čiärguđ	čeargut
čiärgádâh	čeargádat
čiärrum	čearron
čiärruđ	čearrut
čiärsáđ	čearsát
čiärustiđ	čearustit
čiärádiđ	čearádit
čiäráidittiđ	čearáidihttit
čiäráttâs	čearáhttas
čiäskuh	čeaskut
čiäskáđ	čeaskát
čiävláá	čeavlá
čiävus	čeavus
čiävvuđ	čeavvut
čiävđáá	čeavđá
čiččii	čihččii
čiččâm	čihččan
čiččâmâs	čihččamas
čiđđâ	čiđđa
čiŋâdâttâđ	čiŋadadtat
čiŋâttiđ	čiŋadtit
čiŋâttâllâđ	čiŋadtallat
čiŋŋuustiđ	čiŋŋustit
čiŋŋâ	čiŋŋa
čiže-	čiže-
čižet	čižet
čižetpeeli	čižetpeeli
čižetpel	čižetpel
čižetpeln	čižetpeln
čohhoo	čohho
čohčuv	čokčuv
čohčâ	čokča
čohčâluđ	čokčalut
čokke	čohkki
čokkáástâllâđ	čohkkástallat
čokkááttiđ	čohkkáhttit
čokkáđ	čohkkát
čokkâniđ	čohkkanit
čokottâllâđ	čokohttallat
čokánistiđ	čokánistit
čokániđ	čokánit
čolgâm	čolgan
čolgâttiđ	čolgadtit
čolgâđ	čolgat
čolliistiđ	čolliistit
čolliđ	čollit
čolmâsčevđi	čolbmasčevđi
čolásiđ	čolásit
čommoođ	čopmot
čonnuđ	čodnut
čonâdâttâđ	čonadadtat
čonâsiđ	čonasit
čonâstoh	čonastot
čonâstâh	čonastat
čonâttâttâđ	čonadtadtat
čoolmâs	čolbmas
čoolmâsčevđi	čolbmasčevđi
čoonnâđ	čodnat
čoonâm	čonan
čoonâs	čonas
čoorooh	čorot
čoovgâs	čovgas
čoovâr	čovar
čoovâs	čovas
čoođag-	čođag-
čoođâ	čođa
čoođâ-čoođâ	čođa-čođa
čoođâčoolmâg	čođačolbmat
čorohâš	čorohaš
čorostâllâđ	čorostallat
čoskuđ	čoskut
čovduđ	čovdut
čovdâliđ	čovdalit
čovdâšuđ	čovdašut
čovgiistiđ	čovgiistit
čovgiđ	čovgit
čovguđ	čovgut
čovgâd	čovgat
čovgâliđ	čovgalit
čovgâsiđ	čovgasit
čovgâđ	čovgat
čovádiđ	čovádit
čođo	čođo
čođâvaaibâs	čođaváibas
čudâvahe	čudavahi
čuhâlis	čuhalis
čuhânjune	čuhanjuni
čuhčâdum	čukčadon
čuine	čuini
čuiniđ	čuinit
čuináđ	čuinát
čujos	čujos
čujottiđ	čujohttit
čujottâs	čujohttas
čukke	čuhkki
čulliđ	čullit
čunžáá	čunžá
čuoccâđ	čuohccat
čuoggiistiđ	čuoggiistit
čuoggiistâh	čuoggiistat
čuoggiđ	čuoggit
čuohâmâš	čuohamaš
čuoigâdiđ	čuoigadit
čuoigâlittiđ	čuoigalihttit
čuoigâliđ	čuoigalit
čuoigâm	čuoigan
čuoigâmkišto	čuoigamgiito
čuoigâmsaaveeh	čuoigamsáveet
čuoigâmsijvo	čuoigamsijvo
čuoigâmsuábbi	čuoigamsoabbi
čuoigâstâllâđ	čuoigastallat
čuoigâtteijee	čuoigadteijei
čuoigâttiđ	čuoigadtit
čuoigâđ	čuoigat
čuoijâm	čuoijan
čuoijâđ	čuoijat
čuoivâg	čuoivat
čuoivâš	čuoivaš
čuojâldittiđ	čuojaldihttit
čuojân	čuojan
čuojânâs	čuojanas
čuojâtteijee	čuojadteijei
čuojâttiđ	čuojadtit
čuojâttuđ	čuojadtut
čuolduđ	čuoldut
čuoldâ	čuolda
čuoldâsmuorâ	čuoldasmuora
čuoldâssuábbi	čuoldassoabbi
čuoldâstiđ	čuoldastit
čuollâđ	čuollat
čuolmuđ	čuolbmut
čuolmâ	čuolbma
čuolmâdiđ	čuolbmadit
čuolmâduđ	čuolbmadut
čuolmâđ	čuolbmat
čuolâdiđ	čuoladit
čuolâdâttâđ	čuoladadtat
čuolâliđ	čuolalit
čuolâstiđ	čuolastit
čuolâttiđ	čuoladtit
čuolâttuh	čuoladtut
čuolâttâttâđ	čuoladtadtat
čuommiđ	čuopmit
čuomâ	čuoma
čuomâstittiđ	čuomastihttit
čuomâstiđ	čuomastit
čuoppâđ	čuohppat
čuopâttiđ	čuopadtit
čuopâttâh	čuopadtat
čuopâttâs	čuopadtas
čuorgiittâh	čuorgiihttat
čuorgiđ	čuorgit
čuormâs	čuorbmas
čuormâstiđ	čuorbmastit
čuormâsčalme	čuorbmasčalbmi
čuorviđ	čuorvvit
čuorvâkävppi	čuorvvagávppi
čuottii	čuohttii
čuovjiskiällurääsi	čuovjiskeallurási
čuovjisrääsi	čuovjisrási
čuovjâd	čuovjat
čuovviđ	čuovvit
čuovvâd	čuovvat
čuovvâdvuotâ	čuovvadvuohta
čuovvâdâs	čuovvadas
čuovvâl	čuovval
čuovvâđ	čuovvat
čuovâdâs	čuovadas
čuovâniđ	čuovanit
čuovâstuđ	čuovastut
čuovâttiđ	čuovadtit
čuođâlm	čuođaln
čuoškâ	čuoika
čuoškânjune	čuoikanjuni
čuožâ	čuoža
čuožâstittiđ	čuožastihttit
čuožâstiđ	čuožastit
čuožžiittiđ	čuožžiihttit
čuožžâmeh	čuožžamet
čuppáđ	čuhppát
čuppâ	čuhppa
čurgiistiđ	čurgiistit
čurgiistâttâđ	čurgiistadtat
čurgiđ	čurgit
čurgâ	čurga
čurgâd	čurgat
čurmâ	čurbma
čurmâdiđ	čurbmadit
čurmâdâttâđ	čurbmadadtat
čurmâttâttâđ	čurbmadtadtat
čurmâđ	čurbmat
čurtte	čurti
čurttiđ	čurtit
čurttoliđ	čurtolit
čurttáđ	čurtát
čurvolâs	čurvvolas
čurvođ	čurvvot
čuudâ	čuda
čuuhâl	čuhal
čuumâl	čumal
čuuskâš	čuskaš
čuuvtij	čuvtij
čuuvtijsiähá	čuvtijseahá
čuuvâs	čuvas
čuvâgiđ	čuvagit
čuvđe	čuvđi
čuággiđ	čoaggit
čuágguđ	čoaggut
čuággálm	čoaggáln
čuágudiđ	čoagudit
čuágudâttâđ	čoagudadtat
čuáguttâttâđ	čoaguhttadtat
čuágástuh	čoagástut
čuáhtuđ	čoahtut
čuáimuđ	čoaibmut
čuájá	čoajá
čuákkim	čoahkkin
čuákkuđ	čoahkkut
čuákán	čoakán
čuálguh	čoalgut
čuálgui	čoalgui
čuáli	čoali
čuálittem	čoalihtten
čuálittuđ	čoalihttut
čuálluđ	čoallut
čuálmi	čoalbmi
čuámmi	čoapmi
čuámmikietâ	čoapmikeata
čuámmikozzâ	čoapmikozza
čuámáttâslyepi	čoamáhttasluopi
čuámáttâsnuurâs	čoamáhttasnuras
čuámáttâstähti	čoamáhttastáhti
čuánjá	čoanjá
čuápčis	čoapčis
čuárbudiđ	čoarbudit
čuárbuđ	čoarbut
čuárbášiđ	čoarbášit
čuárgu-	čoargu-
čuárgudiđ	čoargudit
čuáruš	čoaruš
čuárvi	čoarvi
čuárvikiäpu	čoarvvikeapu
čuárvittuđ	čoarvvihttut
čuárvum	čoarvvon
čuárvus	čoarvvus
čuárvuttiđ	čoarvvuhttit
čuárvuđ	čoarvvut
čuárvuđâttâđ	čoarvvuđadtat
čuásis	čoasis
čuáskidiđ	čoaskidit
čuáskim	čoaskin
čuáskis	čoaskis
čuáskudâttâđ	čoaskudadtat
čuáskuđ	čoaskut
čuáskáttistiđ	čoaskáhttistit
čuáskáttiđ	čoaskáhttit
čuássid	čoassit
čuávdiliđ	čoavdilit
čuávdiđ	čoavdit
čuávdus	čoavdus
čuávdásiđ	čoavdásit
čuávgádâh	čoavgádat
čuávji	čoavji
čuávji-	čoavji-
čuávjih	čoavjit
čuávjikussâ	čoavjikussa
čuávjimuorâ	čoavjimuora
čuávjinissoon	čoavjinisson
čuávjinjomâttuh	čoavjinjomadtut
čuávjipuálttâs	čoavjipoaltas
čuávjist	čoavjist
čuávjitavdâ	čoavjitavda
čuávjitoppiittoh	čoavjitohppiihttot
čuávjittem	čoavjihtten
čuávjittuđ	čoavjihttut
čuávjudiđ	čoavjudit
čuávjáá	čoavjá
čuávjáđ	čoavját
čuávudeijee	čoavudeijei
čuávudiđ	čoavudit
čuávuliđ	čoavulit
čuávulâs	čoavulas
čuávuttiđ	čoavuhttit
čuávuvâš	čoavuvaš
čuávvoo	čoavvo
čuávvuđ	čoavvut
čuáđgi	čoađgi
čuáŋá	čoaŋá
čuážžuliđ	čoažžulit
čuážžumcagge	čoažžumcaggi
čuážžuđ	čoažžut
čučârdiđ	čučardit
čuđđâ	čuđđa
čyecciđ	čuohccit
čyegis	čuogis
čyehi	čuohi
čyeigee	čuoigei
čyeijil	čuoijil
čyeldim	čuoldin
čyeldimkiäpu	čuoldimgeapu
čyeldimvuálááš	čuoldimvoaláš
čyeldiđ	čuoldit
čyemenjâs	čuomenjas
čyerbi	čuorbi
čyerbidiđ	čuorbidit
čyeti	čuoti
čyetikielâ	čuotikeala
čyevittiđ	čuovihttit
čyevtib	čuovtit
čyeđes	čuođes
čyeŋjiluđ	čuoŋjilut
čyežittiđ	čuožihttit
čyežžiliđ	čuožžilit
čácáduđ	čácádut
čáhálig	čáhálit
čáhániđ	čáhánit
čáitáldâh	čáitáldat
čájádiđ	čájádit
čájánâs	čájánas
čájáttellee	čájáhttellei
čájáttâllâđ	čájáhttallat
čálástâh	čálástat
čáláttâs	čáláhttas
čárvudiđ	čárvvudit
čárvuđ	čárvvut
čááccuđ	čáhccut
čááitus	čáitus
čáálus	čálus
čášnáá	čášná
čäci-	čáci-
čäcijeggi	čácijeggi
čäcijorree	čácijorrei
čäcijoto	čácijoto
čäcikoble	čácikobli
čäcikupâlâs	čácikupalas
čäcileibi	čácileibi
čäciláhháá	čáciláhhá
čäciláá	čácilá
čäcinjaddeđ	čácinjaddet
čäciollee	čáciollei
čäciruáhu	čáciroahu
čäcitulve	čácitulvi
čäcivätti	čáciváhtti
čäcišuáláttâh	čácišoaláhttat
čäittim	čáihttin
čäittiđ	čáihttit
čälistiđ	čálistit
čälittiđ	čálihttit
čällee	čállei
čäsuáivi	čásoaivi
čääci	čáci
čäällim	čállin
čäälliđ	čállit
čääsiacceem	čásiahcceen
čääsiravgâ	čásiravga
čäšni	čášni
šaali	šáli
šaalu	šálu
šaammâđ	šápmat
šaarrân	šárran
šaavvân	šávvan
šaavvâđ	šávvat
šaavâ	šáva
šaddee	šaddei
šaddo	šaddo
šahe	šahi
šalde	šaldi
šaldođ	šaldot
šalligâššâđ	šalligaššat
šallišiđ	šallišit
šalmaa	šalbmá
šalme	šalbmi
šapšâ	šapša
šargâliđ	šargalit
šarijdiđ	šarijdit
šavgâliđ	šavgalit
šavgârdiđ	šavgardit
šavijdiđ	šavijdit
še	ši
šeellâd	šeallat
šeigi	šeigi
šelgâd	šelgat
šelgâsmittiđ	šelgasmihttit
šelgâsmittuđ	šelgasmihttut
šelgâsvuotâ	šelgasvuohta
šeris-	šeris-
šeštee	šeitei
šielâ	šeala
šiervi	šearvi
šiettuht	šeahttuht
šiettuu	šeahttu
šiettuustâllâđ	šeahttustallat
šiettâdiđ	šeahttadit
šiettâl	šeahttal
šiettâđ	šeahttat
šietâdâttâđ	šeatadadtat
šiev	šeav
šievnáál	šeavdnál
šievtátulâš	šeavtátulaš
šievšoŋŋâ	šeavšoŋŋa
šieđâluđ	šeađalut
šiggođ	šiggot
šiiveet	šiiveet
šiiŋâs	šiiŋas
šiljo	šiljo
šipšâđ	šipšat
šiälgudiđ	šealgudit
šiälguh	šealgut
šiälgus	šealgus
šiälguđ	šealgut
šiälgásmittiđ	šealgásmihttit
šiälgáđ	šealgát
šiälluđ	šeallut
šiälláđ	šeallát
šiälmuđ	šealbmut
šiälmá	šealbmá
šiämáttiđ	šeamáhttit
šiärráđ	šearrát
šiärádâh	šearádat
šiätkuđ	šeatgut
šiätudiđ	šeatudit
šiäđudiđ	šeađudit
šiäđust	šeađust
šiäštulâš	šeaitulaš
šiäštálâs	šeaitálas
škaŋkkeđ	škaŋkket
škiŋijdiđ	škiŋijdit
škovliđ	škovlit
škovos	škovos
škuljiđ	škuljit
škurijdiđ	škurijdit
škurnođ	škurnot
škurnádiđ	škurnádit
škuráhittiđ	škuráhihttit
škuráidittiđ	škuráidihttit
škuálmi-	škoalbmi-
škuáŋkkinjune	škoaŋkkinjuni
škuáŋkkuđ	škoaŋkkut
šlaadâr	šládar
šlaajâ	šlája
šlaamâ	šláma
šlaaviittâllâđ	šláviihttallat
šladârdiđ	šladardit
šlahtiđ	šlahtit
šlajâttâllâđ	šlajadtallat
šlamâdiđ	šlamadit
šlarvâ	šlarva
šlarvâdiđ	šlarvvadit
šlebbiđ	šlebbit
šliedâs	šleadas
šlijppiđ	šlijppit
šlijve	šlijvi
šliráhuttiđ	šliráhuhttit
šlivgiđ	šlivgit
šlivgođ	šlivgot
šliämmuđ	šleapmut
šliämu	šleamu
šliäđmuđ	šleađmut
šlobârdiđ	šlobardit
šloggođ	šloggot
šloggâđ	šloggat
šlokkođ	šlohkkot
šlooviđ	šlovit
šlotureh	šloturet
šloŋkkeđ	šloŋkket
šlumppâ	šlumppa
šlunde	šlundi
šluogâstiđ	šluogastit
šluvgeđ	šluvget
šluákkiđ	šloahkkit
šluŋkkepelji	šluŋkkepelji
šláhtár	šláhtár
šnikkáruššâđ	šnihkkáruššat
šnukkáristiđ	šnuhkkáristit
šnukármistiđ	šnukárbmistit
šnurroođ	šnurrot
šnyekki	šnuohkki
šnárkkuđ	šnárkut
šnäkkil	šnáhkkil
šnärkki	šnárki
šnärkkiluđ	šnárkilut
šoddiš	šoddiš
šoddâdemčääci	šoddademčáci
šoddâdiđ	šoddadit
šoddâlâs	šoddalas
šoddâđ	šoddat
šodâlmâs	šodalbmas
šohhoođ	šohhot
šohâniđ	šohanit
šohânâs	šohanas
šolbiđ	šolbit
šolkkâ	šolka
šolliđ	šollit
šolmâštiđ	šolbmaitit
šomer	šomer
šommeer	šopmeer
šoohâd	šohat
šoohâdvuotâ	šohadvuohta
šoollâđ	šollat
šoomeer	šomeer
šordeäimi	šordeáibmi
šovkkel	šovkkel
šovkkâd	šovkkat
šovâttiđ	šovadtit
šoŋŋâ	šoŋŋa
šoŋŋâheivi	šoŋŋaheivi
špuáhuttiđ	špoahuhttit
špuákkárittiđ	špoahkkárihttit
špuákkááttiđ	špoahkkáhttit
špuákkáđ	špoahkkát
šuimâđ	šuibmat
šumpârdiđ	šumpardit
šuoŋâ	šuoŋa
šuoŋŋâm	šuoŋŋan
šuoŋŋâđ	šuoŋŋat
šuuvvâđ	šuvvat
šuuđđân	šuđđan
šuvijdiđ	šuvijdit
šuvvâ	šuvva
šuáhkádiđ	šoahgádit
šuáhkádâs	šoahgádas
šuáhkánjâs	šoahgánjas
šuáláttâh	šoaláhttat
šuáláđ	šoalát
šuámbistiđ	šoambistit
šuármu	šoarbmu
šuávváđ	šoavvát
šuđijdiđ	šuđijdit
šyehkistiđ	šuohgistit
šyeiji	šuoiji
šávduliđ	šávdulit
šávduđ	šávdut
šávguđ	šávgut
šávgáđ	šávgát
šávkkárittiđ	šávkkárihttit
šááráđ	šárát
šááváđ	šávát
šât	šat
šämittiđ	šámihttit
šävittiđ	šávihttit
šävkki	šávkki
